state_fips,county_fips,dem,other,gop,votes,pct_dem,pct_gop,pct_other,pct_non_dem
01,01001,7450,425,19764,27639,26.954665508882375,71.5076522305438,1.537682260573827,73.04533449111763
01,01003,24344,1546,83055,108945,22.345220065170498,76.23571526917252,1.419064665656983,77.6547799348295
01,01005,4772,80,5605,10457,45.63450320359568,53.600459022664246,0.7650377737400784,54.36549679640432
01,01007,1982,83,7508,9573,20.704063511960726,78.42891465580279,0.8670218322364984,79.29593648803927
01,01009,2627,237,24595,27459,9.566990786263156,89.56990422083834,0.8631049928985033,90.43300921373684
01,01011,3439,21,1143,4603,74.71214425374755,24.831631544644797,0.4562242016076472,25.287855746252447
01,01013,3953,65,5448,9466,41.759983097401225,57.55334882738221,0.6866680752165646,58.240016902598775
01,01015,15118,661,34964,50743,29.79327197840096,68.904085292552665,1.302642729046371,70.20672802159905
01,01017,6356,165,8748,15269,41.626825594341476,57.29255353985199,1.080620865806536,58.373174405658524
01,01019,1619,94,10562,12275,13.189409368635438,86.04480651731161,0.7657841140529532,86.81059063136456
01,01021,3056,152,16052,19260,15.867082035306336,83.34371754932502,0.7892004153686396,84.13291796469366
01,01023,3126,41,4294,7461,41.89786891837555,57.552606889156955,0.5495241924674977,58.10213108162445
01,01025,5730,62,7310,13102,43.73378110212182,55.793008700961686,0.4732101969165013,56.26621889787818
01,01027,1262,62,5589,6913,18.25546072616809,80.84767828728484,0.8968609865470852,81.74453927383192
01,01029,672,66,6472,7210,9.320388349514563,89.76421636615811,0.9153952843273232,90.67961165048544
01,01031,5050,298,16832,22180,22.76825969341749,75.88818755635708,1.3435527502254283,77.23174030658251
01,01033,7057,300,17311,24668,28.607913085779145,70.17593643586834,1.2161504783525214,71.39208691422085
01,01035,2951,33,3435,6419,45.972892973983484,53.51300825673781,0.5140987692787038,54.027107026016516
01,01037,1794,52,3626,5472,32.78508771929825,66.26461988304094,0.9502923976608186,67.21491228070175
01,01039,2717,122,14579,17418,15.598805833046276,83.70076931909519,0.7004248478585371,84.40119416695373
01,01041,1700,53,4864,6617,25.691400936980507,73.50763185733716,0.8009672056823334,74.3085990630195
01,01043,4454,493,36804,41751,10.668007951905343,88.15118200761658,1.1808100404780724,89.33199204809466
01,01045,5154,264,14281,19699,26.163764658104473,72.49606579014163,1.340169551753896,73.83623534189553
01,01047,12228,110,5523,17861,68.46201220536365,30.92212082190247,0.6158669727338895,31.53798779463635
01,01049,4271,307,24744,29322,14.565854989427734,84.38714958051975,1.0469954300525204,85.43414501057227
01,01051,10304,498,30089,40891,25.198698980215696,73.58342911643149,1.217871903352816,74.8013010197843
01,01053,4894,123,10844,15861,30.85555765714646,68.36895529916146,0.7754870436920749,69.14444234285354
01,01055,11487,630,35343,47460,24.20353982300885,74.46902654867257,1.3274336283185841,75.79646017699115
01,01057,1390,71,7295,8756,15.87482868889904,83.31429876656007,0.8108725445408863,84.12517131110096
01,01059,2085,115,10364,12564,16.595033428844317,82.489652976759,0.9153135943966889,83.40496657115568
01,01061,1592,102,10844,12538,12.697399904290954,86.48907321741905,0.8135268782899984,87.30260009570904
01,01063,3880,16,875,4771,81.32466988052819,18.33997065604695,0.3353594634248585,18.67533011947181
01,01065,4687,45,3190,7922,59.16435243625347,40.26760918959859,0.5680383741479424,40.83564756374653
01,01067,2589,84,6593,9266,27.940859054608246,71.15260090654004,0.9065400388517159,72.05914094539176
01,01069,12738,628,32384,45750,27.842622950819674,70.78469945355191,1.3726775956284152,72.15737704918033
01,01071,3709,249,19644,23602,15.71476993475129,83.23023472587069,1.0549953393780187,84.28523006524871
01,01073,180936,5296,138443,324675,55.72834372834373,42.64048664048664,1.631169631169631,44.27165627165627
01,01075,978,41,6168,7187,13.607903158480589,85.82162237373035,0.5704744677890636,86.39209684151942
01,01077,11872,699,31578,44149,26.89075630252101,71.52596887811728,1.583274819361707,73.10924369747899
01,01079,3544,147,12266,15957,22.20968853794573,76.86908566773202,0.9212257943222409,77.79031146205426
01,01081,27600,1361,42019,70980,38.88419273034658,59.19836573682728,1.917441532826148,61.11580726965342
01,01083,13510,907,34337,48754,27.710546826927025,70.42909299749765,1.8603601755753374,72.28945317307297
01,01085,4968,27,1835,6830,72.73792093704246,26.866764275256223,0.3953147877013177,27.26207906295754
01,01087,7084,74,1539,8697,81.45337472691733,17.695757157640564,0.8508681154421065,18.546625273082668
01,01089,86885,4675,102395,193955,44.796473408780386,52.79317367430589,2.410352916913717,55.203526591219614
01,01091,5476,69,5337,10882,50.32163205293144,49.044293328432275,0.63407461863628,49.67836794706856
01,01093,1457,139,12190,13786,10.56869287683157,88.42303786450022,1.008269258668214,89.43130712316844
01,01095,5880,518,33094,39492,14.889091461561835,83.799250481110093,1.3116580573280665,85.11090853843817
01,01097,78754,2424,100605,181783,43.32308301656371,55.34345895930862,1.3334580241276686,56.67691698343629
01,01099,4425,66,6129,10620,41.66666666666667,57.711864406779654,0.6214689265536724,58.33333333333333
01,01101,64065,1289,33122,98476,65.05646045737032,33.63459116942199,1.3089483732076852,34.94353954262968
01,01103,13159,819,39504,53482,24.604539845181556,73.86410381062788,1.5313563441905689,75.39546015481844
01,01105,3849,30,1336,5215,73.80632790028763,25.618408437200387,0.5752636625119847,26.193672099712373
01,01107,4017,52,5590,9659,41.58815612382234,57.87348586810229,0.5383580080753702,58.41184387617766
01,01109,5613,163,8020,13796,40.68570600173963,58.13279211365613,1.181501884604233,59.31429399826037
01,01111,2203,73,8548,10824,20.35291943828529,78.97265336289726,0.6744271988174427,79.64708056171472
01,01113,11078,234,9796,21108,52.48247110100436,46.40894447602805,1.1085844229675952,47.51752889899564
01,01115,7698,529,36119,44346,17.358950074414828,81.44815766923736,1.1928922563478104,82.64104992558518
01,01117,33036,1975,79428,114439,28.867781088614898,69.4064086543923,1.7258102569928084,71.13221891138511
01,01119,4639,45,1598,6282,73.84590894619548,25.437758675581023,0.7163323782234957,26.15409105380452
01,01121,13092,289,22210,35591,36.78458037144222,62.40341659408277,0.8120030344750078,63.21541962855778
01,01123,5815,168,14905,20888,27.83895059364228,71.35675986212179,0.8042895442359249,72.16104940635772
01,01125,37514,1285,50961,89760,41.793672014260245,56.774732620320854,1.4315953654188949,58.206327985739755
01,01127,4826,333,25947,31106,15.514691699350609,83.41477528451102,1.0705330161383655,84.4853083006494
01,01129,2253,54,6554,8861,25.426024150773053,73.96456381898206,0.6094120302448933,74.57397584922694
01,01131,4036,22,1826,5884,68.59279401767505,31.033310673011556,0.37389530931339227,31.407205982324953
01,01133,974,112,10187,11273,8.640113545640025,90.36636210414264,0.9935243502173334,91.35988645435998
02,total,150262,13442,185769,349473,42.99674080687206,53.15689624091131,3.8463629522166234,57.00325919312794
04,04001,23293,437,11442,35172,66.22597520755146,32.53155919481406,1.2424655976344818,33.77402479244854
04,04003,23732,1153,35557,60442,39.26408788590715,58.82829820323616,1.907613910856689,60.73591211409285
04,04005,44698,1522,27052,73272,61.00283873785348,36.91996942897696,2.07719183316956,38.99716126214652
04,04007,8943,342,18377,27662,32.32954956257682,66.43409731761984,1.2363531198033402,67.67045043742317
04,04009,4034,212,10749,14995,26.90230076692231,71.68389463154384,1.4138046015338446,73.09769923307769
04,04011,1182,70,2433,3685,32.07598371777476,66.02442333785618,1.8995929443690638,67.92401628222524
04,04012,2236,93,5129,7458,29.981228211316708,68.77178868329311,1.246983105390185,70.0187717886833
04,04013,1040774,31705,995665,2068144,50.32405867289705,48.14292428380229,1.53301704330066,49.67594132710295
04,04015,24831,1302,78535,104668,23.723583139068293,75.03248366262851,1.2439331983032063,76.2764168609317
04,04017,23383,727,27657,51767,45.169702706357334,53.4259277145672,1.4043695790754727,54.830297293642666
04,04019,304981,7658,207758,520397,58.60544930120658,39.922981877297524,1.4715688214958964,41.39455069879342
04,04021,75106,3342,107077,185525,40.48295377981404,57.71567174235278,1.8013744778331762,59.51704622018596
04,04023,13138,224,6194,19556,67.18142769482512,31.673143792186544,1.145428512988341,32.81857230517488
04,04025,49602,2092,91527,143221,34.63318926693711,63.906131084128724,1.4606796489341647,65.36681073306289
04,04027,32210,1137,36534,69881,46.092643207738874,52.28030509008171,1.6270517021794193,53.907356792261126
05,05001,1818,170,4304,6292,28.893833439287985,68.4043229497775,2.70184361093452,71.10616656071201
05,05003,2125,253,5548,7926,26.81049709815796,69.99747665909665,3.192026242745395,73.18950290184205
05,05005,4635,536,15836,21007,22.064073880135194,75.38439567763126,2.5515304422335414,77.9359261198648
05,05007,42249,3698,73965,119912,35.23333778103943,61.682734004936954,3.0839282140236173,64.76666221896056
05,05009,3064,398,13652,17114,17.90347084258502,79.77094776206614,2.3255813953488373,82.09652915741498
05,05011,1214,105,2335,3654,33.22386425834702,63.90257252326218,2.8735632183908044,66.77613574165298
05,05013,479,67,1636,2182,21.952337305224564,74.97708524289642,3.07057745187901,78.04766269477544
05,05015,4023,350,7424,11797,34.10189031109604,62.931253708569976,2.966855980333983,65.89810968890396
05,05017,2260,91,1752,4103,55.08164757494516,42.7004630757982,2.217889349256642,44.91835242505484
05,05019,3438,341,4616,8395,40.95294818344253,54.98511018463371,4.061941631923764,59.04705181655747
05,05021,962,135,4086,5183,18.56067914335327,78.834651746093,2.604669110553733,81.43932085664673
05,05023,1988,364,10328,12680,15.678233438485806,81.45110410094637,2.8706624605678233,84.3217665615142
05,05025,651,82,2867,3600,18.083333333333336,79.63888888888889,2.2777777777777777,81.91666666666666
05,05027,2814,302,5500,8616,32.66016713091922,63.8347260909935,3.5051067780872796,67.33983286908078
05,05029,2615,376,5694,8685,30.109383995394357,65.56131260794473,4.329303396660909,69.89061600460565
05,05031,11921,1032,25558,38511,30.954792137311415,66.365454026122407,2.679753836566176,69.045207862688585
05,05033,4959,525,18607,24091,20.584450624714624,77.23631231580258,2.179237059482795,79.41554937528538
05,05035,8325,517,7244,16086,51.75307720999627,45.032947905010566,3.213974884993162,48.24692279000373
05,05037,1772,224,4946,6942,25.525785076346875,71.24747911264765,3.226735811005474,74.47421492365312
05,05039,963,113,1573,2649,36.35334088335221,59.380898452246136,4.265760664401661,63.64665911664779
05,05041,2016,227,1921,4164,48.414985590778095,46.13352545629203,5.451488952929876,51.585014409221905
05,05043,2426,133,4349,6908,35.11870295309786,62.955993051534456,1.9253039953676898,64.88129704690215
05,05045,18347,1660,34421,54428,33.70875284779893,63.24134636584111,3.0499007863599616,66.29124715220107
05,05047,1300,152,5677,7129,18.235376630663488,79.63248702482817,2.1321363445083463,81.7646233693365
05,05049,1035,123,3961,5119,20.218792732955656,77.37839421762062,2.4028130494237154,79.78120726704435
05,05051,14045,1085,29069,44199,31.776737030249553,65.7684562999163,2.454806669834159,68.22326296975045
05,05053,1268,138,6794,8200,15.463414634146341,82.85365853658536,1.6829268292682928,84.53658536585365
05,05055,3045,370,12651,16066,18.95306859205776,78.74393128345575,2.303000124486493,81.04693140794224
05,05057,2138,240,4470,6848,31.220794392523366,65.27453271028037,3.5046728971962615,68.77920560747663
05,05059,3082,273,9202,12557,24.54407899976109,73.28183483316079,2.1740861670781237,75.4559210002389
05,05061,1340,127,3367,4834,27.72031443938767,69.65246172941664,2.627223831195697,72.27968556061234
05,05063,2806,456,11250,14512,19.33572216097023,77.5220507166483,3.1422271223814775,80.664277839029765
05,05065,1021,158,4631,5810,17.57314974182444,79.70740103270224,2.719449225473322,82.42685025817556
05,05067,1365,133,3593,5091,26.812021213906895,70.57552543704577,2.6124533490473385,73.18797878609311
05,05069,14882,648,9500,25030,59.456652017578904,37.954454654414704,2.5888933280063924,40.543347982421096
05,05071,2283,277,6938,9498,24.03663929248263,73.04695725415877,2.9164034533586016,75.96336070751737
05,05073,839,83,1757,2679,31.31765584173199,65.58417319895483,3.0981709593131765,68.68234415826801
05,05075,1080,208,4569,5857,18.43947413351545,78.00921973706676,3.551306129417791,81.56052586648455
05,05077,1423,139,1286,2848,49.96488764044944,45.15449438202247,4.88061797752809,50.03511235955056
05,05079,1032,114,2729,3875,26.63225806451613,70.4258064516129,2.9419354838709677,73.36774193548388
05,05081,1226,238,3714,5178,23.677095403630748,71.72653534183083,4.596369254538432,76.32290459636926
05,05083,1544,240,6441,8225,18.772036474164132,78.31003039513678,2.917933130699088,81.22796352583586
05,05085,6684,1092,22884,30660,21.800391389432487,74.63796477495107,3.5616438356164384,78.19960861056751
05,05087,1563,130,5658,7351,21.262413277105153,76.96911984763977,1.7684668752550672,78.73758672289485
05,05089,1531,189,5783,7503,20.405171264827402,77.07583633213382,2.5189924030387845,79.5948287351726
05,05091,4245,364,11920,16529,25.682134430395067,72.11567547946034,2.2021900901445943,74.31786556960493
05,05093,4542,483,7262,12287,36.96589891755514,59.10311711565068,3.930983966794173,63.03410108244486
05,05095,1146,124,1545,2815,40.710479573712256,54.88454706927176,4.404973357015986,59.289520426287744
05,05097,731,96,3046,3873,18.87425768138394,78.64704363542474,2.478698683191325,81.12574231861606
05,05099,775,69,1275,2119,36.5738555922605,60.169891458235014,3.256252949504483,63.4261444077395
05,05101,709,97,3192,3998,17.733866933466732,79.83991995998,2.4262131065532766,82.26613306653327
05,05103,3995,340,5294,9629,41.489251220272095,54.97974867587496,3.5310001038529446,58.510748779727905
05,05105,1012,136,3479,4627,21.871623081910524,75.18910741301059,2.939269505078885,78.12837691808947
05,05107,3623,202,2417,6242,58.04229413649471,38.721563601409805,3.2361422620954823,41.95770586350529
05,05109,644,83,3519,4246,15.167216203485633,82.87800282618936,1.9547809703250116,84.83278379651436
05,05111,1424,179,5918,7521,18.93365243983513,78.68634490094402,2.3800026592208483,81.06634756016487
05,05113,1246,209,7035,8490,14.676089517078916,82.86219081272085,2.4617196702002357,85.32391048292108
05,05115,5772,579,18081,24432,23.62475442043222,74.00540275049116,2.3698428290766205,76.37524557956777
05,05117,654,55,2786,3495,18.71244635193133,79.71387696709586,1.5736766809728182,81.28755364806867
05,05119,101947,4322,63687,169956,59.98434889030102,37.47263997740592,2.5430111322930644,40.01565110969898
05,05121,1215,242,5355,6812,17.836171462125662,78.61127422196125,3.5525543159130946,82.16382853787434
05,05123,3604,262,3242,7108,50.70343275182893,45.61057962858751,3.685987619583568,49.29656724817107
05,05125,16060,1343,39556,56959,28.195719728225566,69.44644393335557,2.3578363384188625,71.80428027177443
05,05127,483,106,2962,3551,13.601802309208674,83.41312306392565,2.9850746268656714,86.39819769079132
05,05129,588,66,3365,4019,14.630505100771336,83.72729534710128,1.6421995521273949,85.36949489922867
05,05131,14487,1455,31198,47140,30.73186253712346,66.18158676283412,3.086550700042427,69.26813746287654
05,05133,1116,202,3884,5202,21.453287197231834,74.6635909265667,3.883121876201461,78.54671280276817
05,05135,1398,230,5938,7566,18.477398889770026,78.48268569918055,3.0399154110494315,81.52260111022997
05,05137,1180,142,4616,5938,19.872010778039744,77.73661165375547,2.3913775682047826,80.12798922196026
05,05139,5584,545,10478,16607,33.62437526344312,63.093876076353354,3.281748660203529,66.37562473655689
05,05141,1593,180,6034,7807,20.404764954527987,77.28961188676828,2.3056231587037272,79.59523504547201
05,05143,43824,2938,47504,94266,46.489720577939025,50.39356713979589,3.1167122822650795,53.510279422060975
05,05145,5978,725,24182,30885,19.355674275538288,78.29690788408612,2.3474178403755865,80.64432572446171
05,05147,856,77,1543,2476,34.5718901453958,62.31825525040387,3.109854604200323,65.4281098546042
05,05149,1284,231,5226,6741,19.047619047619047,77.52558967512239,3.4267912772585665,80.95238095238095
06,06001,616180,15856,135925,767961,80.23584530985298,17.699466509367014,2.0646881807800135,19.764154690147024
06,06003,473,25,238,736,64.2663043478261,32.33695652173913,3.3967391304347823,35.73369565217391
06,06005,8152,564,13584,22300,36.5560538116592,60.91479820627803,2.5291479820627805,63.4439461883408
06,06007,49402,2810,47568,99780,49.51092403287232,47.67288033674083,2.816195630386851,50.48907596712768
06,06009,9845,585,16287,26717,36.8491971403975,60.96118576187446,2.1896170977280383,63.1508028596025
06,06011,3213,162,4533,7908,40.62974203338391,57.32169954476479,2.04855842185129,59.37025796661609
06,06013,407639,11620,148623,567882,71.78234210628264,26.17145815503925,2.046199738678106,28.21765789371736
06,06015,4656,313,6434,11403,40.83136016837674,56.42374813645532,2.7448916951679383,59.16863983162326
06,06017,51473,2666,61614,115753,44.46796195346989,53.22885799936071,2.303180047169404,55.53203804653011
06,06019,190403,7180,162438,360021,52.886637168387395,45.11903472297449,1.9943281086381073,47.113362831612605
06,06021,3815,221,6854,10890,35.03213957759412,62.93847566574839,2.029384756657484,64.96786042240588
06,06023,37367,1607,17474,56448,66.19720804988663,30.95592403628118,2.8468679138321997,33.802791950113374
06,06025,31545,1051,18129,50725,62.18827008378511,35.73977328733366,2.0719566288812223,37.81172991621489
06,06027,4623,226,4611,9460,48.86892177589852,48.74207188160676,2.3890063424947146,51.13107822410148
06,06029,124973,6836,152778,284587,43.91381194502911,53.68411065860352,2.4020773963673676,56.08618805497089
06,06031,17729,1035,23169,41933,42.279350392292464,55.252426489876704,2.468223117830825,57.720649607707536
06,06033,6874,209,3955,11038,62.275774596847256,35.83076644319623,1.893458959956514,37.724225403152744
06,06035,2772,209,8798,11779,23.533406910603617,74.69224891756517,1.7743441718312252,76.46659308939638
06,06037,3001862,87809,1132647,4222318,71.09511884230416,26.82524149057461,2.079639667121235,28.90488115769584
06,06039,22814,1157,29065,53036,43.01606455992156,54.80239837091787,2.18153706916057,56.98393544007844
06,06041,126652,2816,24007,153475,82.52288646359341,15.642287017429549,1.834826518977032,17.47711353640659
06,06043,4088,242,5950,10280,39.766536964980546,57.87937743190662,2.3540856031128405,60.233463035019454
06,06045,18303,556,6312,25171,72.71463191768305,25.076476898017557,2.208891184299392,27.28536808231695
06,06047,47861,2104,38568,88533,54.06006799724396,43.563417030937615,2.376514971818418,45.93993200275604
06,06049,1063,67,2675,3805,27.936925098554532,70.30223390275953,1.7608409986859395,72.063074901445475
06,06051,3998,211,2504,6713,59.55608520780575,37.30075971994638,3.143155072247877,40.44391479219425
06,06053,113893,3630,46274,163797,69.53301953027223,28.25082266463977,2.216157805088005,30.466980469727773
06,06055,46962,1497,19388,67847,69.21750409008504,28.576060842778606,2.206435067136351,30.782495909914957
06,06057,35773,1556,26316,63645,56.207086181161124,41.34810275748291,2.4448110613559586,43.792913818838876
06,06059,813132,31187,675855,1520174,53.48940318674047,44.45905534498025,2.051541468279289,46.51059681325953
06,06061,103108,5375,117426,225909,45.641386576010696,51.97933681261039,2.379276611378918,54.358613423989304
06,06063,4465,238,6247,10950,40.77625570776256,57.050228310502284,2.1735159817351595,59.22374429223744
06,06065,511967,18761,433374,964102,53.10299117728208,44.95105289689265,1.9459559258252757,46.89700882271792
06,06067,434512,17730,253959,706201,61.528091860532626,35.961291473673924,2.51061666579345,38.471908139467374
06,06069,17315,590,10412,28317,61.14701416110464,36.769431790090756,2.083554048804605,38.85298583889536
06,06071,439705,17983,352781,810469,54.25315465489735,43.5280066233255,2.218838721777144,45.74684534510265
06,06073,962325,36844,598434,1597603,60.23555288766984,37.4582421289895,2.3062049833406673,39.76444711233016
06,06075,377772,8868,56329,442969,85.28181430303249,12.716239736866463,2.0019459601010454,14.71818569696751
06,06077,152056,5741,113627,271424,56.02157510021222,41.863284013204435,2.115140886583353,43.97842489978778
06,06079,86829,3826,65907,156562,55.45981783574558,42.09642186482033,2.44376029943409,44.54018216425442
06,06081,288333,6983,74756,370072,77.91267645214985,20.200393436952808,1.8869301108973386,22.087323547850147
06,06083,126419,4376,63583,194378,65.03771002891273,32.71100638961199,2.2512835814752696,34.96228997108727
06,06085,615258,17828,213518,846604,72.67364671085892,25.22052813357839,2.105825155562695,27.326353289141082
06,06087,113487,3582,26688,143757,78.94363404912457,18.564661199106826,2.4917047517686095,21.05636595087543
06,06089,29312,2027,58886,90225,32.48766971460238,65.26572457744527,2.2466057079523414,67.51233028539761
06,06091,730,58,1142,1930,37.82383419689119,59.17098445595855,3.005181347150259,62.17616580310881
06,06093,9591,567,13288,23446,40.90676448008189,56.67491256504308,2.418322954875032,59.09323551991811
06,06095,131525,4881,69234,205640,63.95886014394087,33.66757440186734,2.3735654541917914,36.04113985605913
06,06097,197010,6326,60355,263691,74.71244752380628,22.888532411041712,2.399020065152015,25.287552476193724
06,06099,104323,4810,102568,211701,49.27846349332313,48.44946410267311,2.27207240400376,50.72153650667687
06,06101,16961,869,23864,41694,40.67971410754545,57.23605314913417,2.0842327433203818,59.32028589245455
06,06103,8493,594,17739,26826,31.65958398568553,66.1261462760009,2.2142697383135763,68.34041601431447
06,06105,2848,219,3185,6252,45.553422904670505,50.94369801663468,3.502879078694818,54.446577095329495
06,06107,65056,3077,76315,144448,45.0376606114311,52.83216105449712,2.130178334071777,54.9623393885689
06,06109,11808,710,17302,29820,39.59758551307847,58.02146210596915,2.380952380952381,60.40241448692153
06,06111,250535,9034,161510,421079,59.49833641668191,38.356222941538284,2.1454406417798086,40.50166358331809
06,06113,53621,1577,19825,75023,71.47274835717047,26.42522959625715,2.1020220465723845,28.527251642829526
06,06115,10343,776,16210,27329,37.8462439167185,59.31428153243807,2.839474550843426,62.1537560832815
08,08001,134202,6876,95657,236735,56.68870255771221,40.40678395674489,2.9045134855429064,43.31129744228779
08,08003,3759,236,3813,7808,48.142930327868854,48.83452868852459,3.0225409836065573,51.857069672131146
08,08005,213673,9254,127356,350283,61.00010562887722,36.35803050676167,2.6418638643611025,38.99989437112278
08,08007,3738,217,5189,9144,40.879265091863516,56.74759405074366,2.373140857392826,59.120734908136484
08,08009,317,41,1866,2224,14.253597122302159,83.90287769784173,1.8435251798561152,85.74640287769785
08,08011,732,39,1503,2274,32.189973614775724,66.09498680738787,1.7150395778364116,67.81002638522428
08,08013,159089,4521,42501,206111,77.18607934559533,20.620442382987807,2.1934782714168577,22.81392065440467
08,08014,29077,1260,16295,46632,62.354177388917485,34.94381540572997,2.7020072053525475,37.645822611082515
08,08015,7160,335,6222,13717,52.198002478676095,45.35977254501713,2.4422249763067727,47.801997521323905
08,08017,131,12,993,1136,11.53169014084507,87.41197183098592,1.056338028169014,88.46830985915493
08,08019,3603,189,2753,6545,55.04965622612682,42.062643239113825,2.8877005347593583,44.95034377387318
08,08021,1959,88,2286,4333,45.211170090006924,52.75790445418879,2.030925455804293,54.788829909993076
08,08023,1311,42,741,2094,62.607449856733524,35.38681948424069,2.005730659025788,37.392550143266476
08,08025,437,42,1271,1750,24.97142857142857,72.62857142857143,2.4,75.02857142857142
08,08027,1111,48,2471,3630,30.606060606060602,68.07162534435261,1.322314049586777,69.3939393939394
08,08029,5887,402,13081,19370,30.392359318533813,67.53226639132679,2.075374290139391,69.6076406814662
08,08031,313292,8915,71617,393824,79.55127163402942,18.18502681400829,2.263701551962298,20.44872836597058
08,08033,341,19,1089,1449,23.533471359558316,75.15527950310559,1.3112491373360937,76.46652864044168
08,08035,104653,5676,121270,231599,45.18715538495417,52.362056830988045,2.4507877840577894,54.81284461504583
08,08037,18588,660,9891,29139,63.79079584062597,33.944198496859876,2.2650056625141564,36.20920415937403
08,08039,4490,466,14027,18983,23.652741926987307,73.89243006900912,2.454828004003582,76.3472580730127
08,08041,161636,14038,202560,378234,42.734391937266345,53.55414901886134,3.7114590438723116,57.265608062733655
08,08043,7369,671,17517,25557,28.833587666784048,68.5409085573424,2.6255037758735376,71.16641233321596
08,08045,15427,760,14717,30904,49.91910432306498,47.62166709811028,2.4592285788247477,50.08089567693502
08,08047,2222,130,1833,4185,53.09438470728794,43.799283154121866,3.106332138590203,46.90561529271206
08,08049,4709,277,4883,9869,47.71506738271355,49.47816394771507,2.8067686695713854,52.28493261728645
08,08051,6976,312,3599,10887,64.07642142004225,33.05777532837329,2.8658032515844587,35.92357857995775
08,08053,255,24,353,632,40.348101265822784,55.85443037974683,3.79746835443038,59.651898734177216
08,08055,2076,127,2203,4406,47.117566954153425,50,2.882433045846573,52.882433045846575
08,08057,175,20,681,876,19.97716894977169,77.73972602739725,2.28310502283105,80.0228310502283
08,08059,218393,10544,148414,377351,57.87529382458242,39.3304907102406,2.7942154651769835,42.12470617541758
08,08061,98,10,795,903,10.852713178294573,88.03986710963456,1.1074197120708749,89.14728682170542
08,08063,662,65,3143,3870,17.10594315245478,81.21447028423773,1.6795865633074936,82.89405684754522
08,08065,2303,161,1497,3961,58.14188336278717,37.79348649330977,4.064630143903055,41.85811663721283
08,08067,20548,886,14233,35667,57.610676535733305,39.905234530518406,2.484088933748283,42.389323464266695
08,08069,126117,6728,91488,224333,56.218657085671744,40.78222998845467,2.9991129258735896,43.781342914328256
08,08071,3497,180,4284,7961,43.92664238161035,53.81233513377717,2.261022484612486,56.07335761838965
08,08073,470,46,2135,2651,17.729158807996985,80.53564692568843,1.735194266314598,82.27084119200302
08,08075,2218,227,8087,10532,21.059627800987464,76.78503608051652,2.155336118496012,78.94037219901253
08,08077,31533,2192,56888,90613,34.79964243541214,62.78127862447993,2.419078940107932,65.20035756458786
08,08079,317,12,427,756,41.93121693121693,56.481481481481474,1.5873015873015872,58.06878306878307
08,08081,1203,153,5670,7026,17.122117847993167,80.7002561912895,2.1776259607173354,82.87788215200683
08,08083,5836,358,9306,15500,37.651612903225804,60.038709677419355,2.3096774193548386,62.348387096774196
08,08085,7687,465,16770,24922,30.84423401011155,67.28994462723698,1.8658213626514726,69.15576598988845
08,08087,3876,275,9593,13744,28.20139697322468,69.7977299185099,2.000873108265425,71.79860302677533
08,08089,3605,215,5756,9576,37.646198830409354,60.108604845446955,2.2451963241436923,62.353801169590646
08,08091,2365,78,1577,4020,58.83084577114428,39.22885572139304,1.9402985074626864,41.16915422885572
08,08093,4903,396,6990,12289,39.89746928147123,56.88013670762471,3.2223940109040603,60.10253071852877
08,08095,486,41,1958,2485,19.557344064386317,78.79275653923541,1.6498993963782695,80.44265593561369
08,08097,8989,188,2780,11957,75.17772016392071,23.24997909174542,1.572300744333863,24.82227983607929
08,08099,1458,95,4008,5561,26.218306060061142,72.07336809926272,1.7083258406761375,73.78169393993886
08,08101,43772,2275,42252,88299,49.572475339471566,47.85105154078755,2.5764731197408803,50.427524660528434
08,08103,561,69,3061,3691,15.19913302628014,82.93145489027364,1.8694120834462207,84.80086697371986
08,08105,2495,150,3660,6305,39.57176843774782,58.04916732751785,2.379064234734338,60.42823156225218
08,08107,10582,369,5925,16876,62.704432329936,35.10903057596587,2.1865370940981275,37.295567670064
08,08109,1884,92,1413,3389,55.591619946886986,41.69371496016524,2.7146650929477723,44.408380053113014
08,08111,342,19,202,563,60.746003552397866,35.879218472468914,3.374777975133215,39.253996447602134
08,08113,3923,87,1136,5146,76.23396813058686,22.075398367664206,1.6906335017489313,23.76603186941314
08,08115,301,24,1121,1446,20.816044260027663,77.52420470262794,1.6597510373443984,79.18395573997233
08,08117,12620,526,5319,18465,68.34551854860547,28.805848903330627,2.8486325480639048,31.65448145139453
08,08119,5278,420,11241,16939,31.158864159631623,66.36165062872661,2.4794852116417734,68.84113584036838
08,08121,369,44,2595,3008,12.267287234042554,86.26994680851064,1.4627659574468086,87.73271276595744
08,08123,66050,4763,96133,166946,39.563691253459204,57.58329040528075,2.8530183412600483,60.436308746540796
08,08125,785,89,4107,4981,15.75988757277655,82.45332262597871,1.78678980124473,84.24011242722345
09,09001,296239,6612,167905,470756,62.92835354196229,35.66709717985538,1.4045492781823279,37.07164645803771
09,09003,284341,7040,159370,450751,63.081612686383394,35.35654940310726,1.56183791050935,36.918387313616606
09,09005,50164,1784,55609,107557,46.63945628829365,51.70188830108686,1.6586554106194855,53.36054371170635
09,09007,56848,1685,40665,99198,57.30760700820581,40.993770035686204,1.6986229561079862,42.69239299179419
09,09009,242628,5460,170354,418442,57.98366320780419,40.7114964559007,1.3048403362951138,42.01633679219581
09,09011,79459,3035,57110,139604,56.917423569525226,40.908569955015615,2.174006475459156,43.082576430474774
09,09013,44006,1721,34819,80546,54.63461872718695,43.228714026767314,2.1366672460457377,45.36538127281305
09,09015,26702,1235,29141,57078,46.78159711272294,51.05469708118715,2.163705806089912,53.21840288727706
10,10001,44552,1464,41009,87025,51.194484343579425,47.12324044814709,1.6822752082734846,48.805515656420575
10,10003,195034,4235,88364,287633,67.80654514607156,30.721092503294127,1.4723623506343153,32.19345485392844
10,10005,56682,1440,71230,129352,43.819964128888614,55.066794483270456,1.1132413878409302,56.180035871111386
11,11001,614530,16490,36344,667364,92.08318099268166,5.445903584850247,2.4709154224680985,7.916819007318338
12,12001,89704,1928,50972,142604,62.904266359989904,35.74373790356511,1.3519957364449804,37.095733640010096
12,12003,2037,111,11911,14059,14.488939469379044,84.72153069208336,0.7895298385375915,85.51106053062095
12,12005,25614,1313,66097,93024,27.53482972136223,71.05370657034744,1.4114637082903336,72.46517027863777
12,12007,3160,138,10334,13632,23.18075117370892,75.80692488262912,1.012323943661972,76.81924882629107
12,12009,148549,4332,207883,360764,41.17622600924704,57.62298899003226,1.2007850007206928,58.82377399075296
12,12011,618752,5511,333409,957672,64.6100126139221,34.81452940046279,0.5754579856151166,35.389987386077905
12,12013,1209,43,5274,6526,18.52589641434263,80.81520073551947,0.65890285013791,81.47410358565737
12,12015,42273,824,73243,116340,36.335740072202164,62.955991060684205,0.7082688671136325,63.664259927797836
12,12017,27092,764,65352,93208,29.066174577289505,70.11415329156296,0.819672131147541,70.9338254227105
12,12019,38317,1608,84480,124405,30.80020899481532,67.90723845504601,1.29255255013866,69.19979100518468
12,12021,77621,1247,128950,207818,37.350470122896,62.04948560759895,0.6000442695050477,62.649529877104
12,12023,8914,292,23836,33042,26.977785848314266,72.13849040614974,0.8837237455359845,73.02221415168573
12,12027,4259,87,8313,12659,33.644047713089506,65.66869420965321,0.6872580772572874,66.3559522869105
12,12029,1365,43,6759,8167,16.713603526386677,82.75988735153668,0.5265091220766499,83.28639647361332
12,12031,252556,6502,233762,492820,51.247108477740355,47.43354571648878,1.3193458057708698,48.752891522259645
12,12033,70929,2769,96674,170372,41.63184091282605,56.74289202451107,1.6252670626628787,58.36815908717395
12,12035,28161,512,43043,71716,39.26738803056501,60.01868481231525,0.7139271571197502,60.73261196943499
12,12037,2120,54,4675,6849,30.953423857497448,68.25813987443422,0.7884362680683311,69.04657614250254
12,12039,16153,144,7465,23762,67.97828465617373,31.415705748674355,0.6060095951519232,32.02171534382627
12,12041,1700,90,7895,9685,17.552916881775943,81.51781104801239,0.9292720702116675,82.44708311822406
12,12043,1385,26,3782,5193,26.670518005006738,72.82880801078375,0.5006739842095128,73.32948199499326
12,12045,1985,65,6113,8163,24.317040303809872,74.88668381722407,0.7962758789660663,75.68295969619012
12,12047,1963,52,3815,5830,33.67066895368782,65.43739279588337,0.8919382504288165,66.32933104631218
12,12049,2298,65,6122,8485,27.083087802003536,72.15085444902769,0.7660577489687684,72.91691219799647
12,12051,4929,105,7906,12940,38.091190108191654,61.09737248840804,0.8114374034003091,61.908809891808346
12,12053,37519,991,70412,108922,34.44575016984631,64.64442445052423,0.9098253796294596,65.55424983015368
12,12055,16938,359,34873,52170,32.466935020126506,66.8449300364194,0.6881349434540924,67.5330649798735
12,12057,376367,8298,327398,712063,52.85585685536252,45.9787968199443,1.1653463246931803,47.14414314463748
12,12059,924,64,8080,9068,10.189677988531098,89.10454344949272,0.7057785619761799,89.8103220114689
12,12061,37844,768,58872,97484,38.82072955561938,60.391448853145135,0.7878215912354849,61.17927044438062
12,12063,6766,165,15488,22419,30.17975824077791,69.08425888755075,0.7359828716713501,69.82024175922209
12,12065,3897,75,4479,8451,46.11288604898828,52.999645012424565,0.8874689385871495,53.88711395101172
12,12067,510,20,3128,3658,13.942044833242209,85.5112083105522,0.5467468562055768,86.0579551667578
12,12069,83505,1950,125859,211314,39.517022061955196,59.560180584343684,0.9227973537011273,60.482977938044804
12,12071,157695,2957,233247,393899,40.034374293917985,59.21492565353047,0.7507000525515425,59.965625706082015
12,12073,103517,1959,57453,162929,63.53503673379202,35.26259904621031,1.2023642199976676,36.46496326620798
12,12075,6205,191,16749,23145,26.809246057463813,72.36552171095269,0.8252322315834953,73.19075394253619
12,12077,694,21,2846,3561,19.488907610221847,79.92137040157259,0.5897219882055602,80.51109238977816
12,12079,3747,57,5576,9380,39.946695095948826,59.44562899786781,0.6076759061833689,60.053304904051174
12,12081,90166,1805,124987,216958,41.559195789046726,57.60884595175103,0.831958259202242,58.440804210953274
12,12083,74858,1692,127826,204376,36.6275883665401,62.54452577602066,0.8278858574392296,63.3724116334599
12,12085,36893,665,61168,98726,37.36908210603083,61.95733646658428,0.6735814273848834,62.63091789396917
12,12086,617864,6119,532833,1156816,53.41074120689894,46.06030691138435,0.528951881716712,46.58925879310106
12,12087,21881,455,25693,48029,45.55789210685211,53.49476358033688,0.9473443128110101,54.44210789314789
12,12089,15564,681,42566,58811,26.464436925065037,72.37761643230009,1.1579466426348812,73.53556307493497
12,12091,34248,2327,79798,116373,29.42950684437112,68.57088843632114,1.9996047193077433,70.57049315562888
12,12093,4390,94,11470,15954,27.516610254481634,71.89419581296227,0.5891939325560988,72.48338974551837
12,12095,395014,6991,245398,647403,61.01516366158328,37.90498344925803,1.0798528891586847,38.98483633841672
12,12097,97297,1659,73480,172436,56.424992460971026,42.61291145700434,0.9620960820246353,43.575007539028974
12,12099,433572,4875,334711,773158,56.078059077187326,43.291410035206255,0.6305308876064142,43.921940922812674
12,12101,119073,3276,179621,301970,39.43206278769414,59.483061231248136,1.0848759810577209,60.56793721230586
12,12103,277450,6056,276209,559715,49.56987038046148,49.3481503979704,1.0819792215681194,50.43012961953852
12,12105,145049,3621,194586,343256,42.25679958981053,56.688302607966065,1.0548978022234134,57.74320041018947
12,12107,10527,332,25514,36373,28.94179748714706,70.14543754983092,0.9127649630220218,71.05820251285294
12,12109,63850,1826,110946,176622,36.15064940947334,62.815504297312906,1.033846293213756,63.84935059052666
12,12111,84137,1201,86831,172169,48.86884398468946,50.43358560484176,0.6975704104687835,51.13115601531054
12,12113,27612,1931,77385,106928,25.8229836899596,72.37112823582224,1.8058880742181656,74.1770163100404
12,12115,120110,2095,148370,270575,44.39064954264067,54.83507345467985,0.7742770026794789,55.60935045735933
12,12117,132528,3046,125241,260815,50.813028391771944,48.01909399382704,1.1678776144010121,49.186971608228056
12,12119,29341,383,62761,92485,31.72514461804617,67.86073417310915,0.4141212088446775,68.27485538195383
12,12121,4485,162,16410,21057,21.29933038894429,77.93132924918079,0.769340361874911,78.7006696110557
12,12123,2299,77,7751,10127,22.70168855534709,76.53796780882789,0.7603436358250222,77.29831144465291
12,12125,1053,59,5133,6245,16.861489191353083,82.1937550040032,0.9447558046437149,83.13851080864691
12,12127,130575,3043,173821,307439,42.47183994223244,56.53837021327808,0.989789844489476,57.52816005776756
12,12129,5351,179,12874,18404,29.075201043251468,69.95218430775918,0.9726146489893502,70.92479895674853
12,12131,10338,426,32947,43711,23.65079728214866,75.3746196609549,0.9745830568964334,76.34920271785134
12,12133,2347,104,9876,12327,19.039506773748684,80.11681674373327,0.8436764825180498,80.96049322625132
13,13001,1779,36,6526,8341,21.32837789233905,78.24001918235224,0.43160292530871597,78.67162210766095
13,13003,825,30,2300,3155,26.148969889064976,72.90015847860539,0.9508716323296356,73.85103011093503
13,13005,625,25,4018,4668,13.389031705227078,86.07540702656384,0.5355612682090831,86.61096829477292
13,13007,652,6,897,1555,41.92926045016077,57.68488745980708,0.3858520900321543,58.07073954983923
13,13009,9140,208,8903,18251,50.0794477014958,48.78088871842638,1.1396635800778039,49.9205522985042
13,13011,932,74,7795,8801,10.58970571525963,88.5694807408249,0.8408135439154643,89.41029428474037
13,13013,10453,760,26804,38017,27.495594076334275,70.50530026040983,1.9991056632559119,72.50440592366573
13,13015,12092,701,37674,50467,23.960211623437097,74.6507618840034,1.3890264925594944,76.03978837656291
13,13017,2392,58,4110,6560,36.46341463414634,62.65243902439024,0.8841463414634145,63.53658536585366
13,13019,1269,55,6419,7743,16.388996512979464,82.90068448921608,0.7103189978044685,83.61100348702054
13,13021,43468,749,26585,70802,61.39374593938024,37.54837433970792,1.0578797209118387,38.60625406061976
13,13023,1311,67,4328,5706,22.97581493165089,75.84998247458815,1.1742025937609533,77.02418506834911
13,13025,699,56,6991,7746,9.024012393493416,90.2530338239091,0.7229537825974697,90.97598760650658
13,13027,2790,50,4260,7100,39.29577464788732,60,0.7042253521126761,60.70422535211268
13,13029,6739,357,14244,21340,31.579194001874416,66.74789128397376,1.6729147141518277,68.42080599812559
13,13031,11243,455,18386,30084,37.372024996675975,61.11554314585826,1.5124318574657625,62.627975003324025
13,13033,5209,75,5400,10684,48.75514788468738,50.54286783976038,0.7019842755522276,51.24485211531262
13,13035,3272,112,8405,11789,27.754686572228348,71.29527525659513,0.9500381711765205,72.24531342777165
13,13037,1260,11,923,2194,57.42935278030994,42.06927985414767,0.5013673655423884,42.57064721969006
13,13039,7967,470,15251,23688,33.63306315433975,64.38280986153326,1.984126984126984,66.36693684566025
13,13043,1269,29,3134,4432,28.632671480144406,70.71299638989169,0.6543321299638989,71.36732851985559
13,13045,16238,760,37476,54474,29.808716084737675,68.79612292102655,1.3951609942357823,70.19128391526232
13,13047,6932,593,25167,32692,21.20396427260492,76.98213630245931,1.813899424935764,78.79603572739508
13,13049,1103,44,3419,4566,24.156811213315812,74.8795444590451,0.9636443276390714,75.84318878668418
13,13051,78369,1932,53288,133589,58.66426127899752,39.88951186100652,1.4462268599959578,41.33573872100248
13,13053,667,43,880,1590,41.9496855345912,55.34591194968554,2.7044025157232707,58.0503144654088
13,13055,1854,132,8064,10050,18.44776119402985,80.23880597014926,1.3134328358208955,81.55223880597015
13,13057,42794,2449,99587,144830,29.54774563281088,68.76130635917973,1.6909480080093904,70.45225436718911
13,13059,36048,839,14446,51333,70.22383262228975,28.141741180137537,1.6344261975727117,29.77616737771025
13,13061,790,7,637,1434,55.090655509065556,44.42119944211995,0.4881450488145049,44.909344490934444
13,13063,95476,1055,15813,112344,84.98540197963398,14.075518051698355,0.9390799686676635,15.014598020366023
13,13065,747,12,2105,2864,26.08240223463687,73.49860335195531,0.41899441340782123,73.91759776536313
13,13067,221846,6441,165459,393746,56.3424136372179,42.02176022105621,1.6358261417258841,43.6575863627821
13,13069,4511,125,10578,15214,29.650322071775996,69.52806625476535,0.8216116734586564,70.349677928224
13,13071,4187,119,11777,16083,26.033700180314618,73.2263881116707,0.7399117080146739,73.96629981968539
13,13073,29236,1330,50013,80579,36.282406085952914,62.06703979945147,1.6505541145956142,63.717593914047086
13,13075,2059,76,4900,7035,29.267945984363898,69.65174129353234,1.0803127221037667,70.7320540156361
13,13077,24210,1088,51501,76799,31.5238479667704,67.05946692014219,1.4166851130874099,68.4761520332296
13,13079,1615,59,4428,6102,26.46673221894461,72.56637168141593,0.9668960996394625,73.53326778105539
13,13081,2986,79,4987,8052,37.08395429706905,61.93492300049677,0.9811227024341779,62.91604570293095
13,13083,1261,107,6066,7434,16.962604250739844,81.59806295399515,1.4393327952649986,83.03739574926016
13,13085,2486,197,13398,16081,15.459237609601391,83.3157141968783,1.2250481935203035,84.54076239039861
13,13087,4780,89,6758,11627,41.11120667412058,58.123333620022365,0.7654597058570568,58.88879332587942
13,13089,308140,4202,58369,370711,83.12135329137791,15.745149186293366,1.1334975223287143,16.878646708622085
13,13091,2171,56,5843,8070,26.90210656753408,72.40396530359355,0.6939281288723668,73.09789343246592
13,13093,1911,35,2159,4105,46.552984165651644,52.59439707673569,0.8526187576126675,53.447015834348356
13,13095,24579,280,10449,35308,69.61311883992296,29.593859748498925,0.7930214115781126,30.38688116007704
13,13097,42809,837,25451,69097,61.954932920387286,36.83372650042694,1.2113405791857823,38.045067079612714
13,13099,2437,28,2722,5187,46.982841719683826,52.477347214189315,0.5398110661268556,53.017158280316174
13,13101,167,18,1256,1441,11.589174184594032,87.1616932685635,1.2491325468424705,88.41082581540597
13,13103,7720,547,23357,31624,24.411839109537063,73.85846192764988,1.7296989628130532,75.58816089046294
13,13105,2879,66,6226,9171,31.392432668193216,67.88790753462,0.7196597971867844,68.60756733180679
13,13107,2884,66,6551,9501,30.35469950531523,68.95063677507632,0.6946637196084623,69.64530049468476
13,13109,1324,35,2888,4247,31.174947021426892,68.00094184129975,0.8241111372733695,68.82505297857311
13,13111,2571,110,12169,14850,17.313131313131315,81.94612794612794,0.7407407407407408,82.68686868686868
13,13113,31937,933,36375,69245,46.12174164199581,52.53086865477652,1.3473897032276698,53.87825835800419
13,13115,10972,496,27120,38588,28.43370996164611,70.28091634705089,1.2853736913029958,71.56629003835388
13,13117,42203,1980,85122,129305,32.63833571787634,65.83040098990757,1.5312632922160783,67.36166428212366
13,13119,1593,124,9069,10786,14.769145188206934,84.08121639161877,1.1496384201743002,85.23085481179307
13,13121,381144,6275,137240,524659,72.64604247711371,26.1579425874711,1.1960149354151934,27.35395752288629
13,13123,2932,164,13429,16525,17.742813918305597,81.26475037821483,0.9924357034795763,82.2571860816944
13,13125,155,8,1403,1566,9.897828863346104,89.59131545338442,0.5108556832694764,90.1021711366539
13,13127,15879,489,25616,41984,37.82155106707317,61.01371951219512,1.1647294207317074,62.17844893292683
13,13129,4384,244,19405,24033,18.241584487995674,80.74314484250822,1.0152706694961096,81.75841551200432
13,13131,3619,54,7034,10707,33.800317549266836,65.69533949752498,0.5043429532081816,66.19968245073316
13,13133,4088,91,7068,11247,36.347470436560855,62.84342491331022,0.8091046501289233,63.652529563439145
13,13135,241827,5625,166413,413865,58.43137254901961,40.20948860135552,1.3591388496248777,41.56862745098039
13,13137,3563,232,16637,20432,17.438332028191073,81.42619420516837,1.1354737666405637,82.56166797180893
13,13139,25031,1322,64170,90523,27.651536073705024,70.88806159760502,1.4604023286899461,72.34846392629498
13,13141,2985,21,1159,4165,71.66866746698679,27.827130852340936,0.5042016806722689,28.33133253301321
13,13143,1792,149,12331,14272,12.556053811659194,86.39994394618834,1.0440022421524664,87.4439461883408
13,13145,5457,215,14319,19991,27.297283777699967,71.62723225451452,1.0754839677855035,72.70271622230004
13,13147,3157,106,9464,12727,24.805531547104582,74.36159346271705,0.832874990178361,75.19446845289542
13,13149,824,57,4516,5397,15.267741337780249,83.67611636094126,1.056142301278488,84.73225866221975
13,13151,73276,1279,48187,122742,59.6992064655945,39.25877042903,1.042023105375503,40.3007935344055
13,13153,32232,1057,41534,74823,43.07766328535344,55.50966948665518,1.412667227991393,56.92233671464656
13,13155,1008,26,3134,4168,24.184261036468328,75.19193857965452,0.6238003838771593,75.81573896353167
13,13157,7642,531,29497,37670,20.286700292009556,78.30368993894345,1.409609769046987,79.71329970799044
13,13159,1761,61,5822,7644,23.03767660910518,76.16431187859759,0.7980115122972266,76.96232339089482
13,13161,1028,48,4695,5771,17.813203950788427,81.35505111765725,0.8317449315543233,82.18679604921158
13,13163,4061,44,3537,7642,53.14053912588328,46.283695367704794,0.575765506411934,46.85946087411672
13,13165,1266,28,2161,3455,36.6425470332851,62.54703328509407,0.8104196816208393,63.3574529667149
13,13167,1222,28,2850,4100,29.804878048780488,69.51219512195121,0.6829268292682927,70.1951219512195
13,13169,4888,113,9965,14966,32.66069758118402,66.58425765067486,0.7550447681411199,67.33930241881598
13,13171,2615,94,6330,9039,28.930191392853192,70.02987056090275,1.0399380462440535,71.06980860714681
13,13173,1019,48,2509,3576,28.49552572706935,70.16219239373602,1.342281879194631,71.50447427293065
13,13175,8073,163,14493,22729,35.51850059395486,63.76435390910291,0.7171454969422324,64.48149940604515
13,13177,4558,149,12007,16714,27.270551633361258,71.8379801364126,0.8914682302261577,72.72944836663874
13,13179,13099,331,7959,21389,61.241759783066065,37.21071578848941,1.5475244284445275,38.758240216933935
13,13181,1435,36,3179,4650,30.86021505376344,68.36559139784947,0.7741935483870968,69.13978494623656
13,13183,2033,95,3528,5656,35.94413012729844,62.37623762376238,1.6796322489391797,64.05586987270155
13,13185,20117,547,25691,46355,43.3976917268903,55.42228454319922,1.1800237299104737,56.6023082731097
13,13187,3126,242,12163,15531,20.127486961560752,78.31433906380786,1.5581739746313823,79.87251303843925
13,13189,4168,118,6169,10455,39.866092778574846,59.005260640841705,1.128646580583453,60.133907221425154
13,13191,2612,68,4016,6696,39.00836320191159,59.976105137395464,1.015531660692951,60.99163679808841
13,13193,2857,22,1783,4662,61.282711282711276,38.24538824538825,0.4719004719004719,38.717288717288724
13,13195,3411,200,11326,14937,22.83591082546696,75.82513222199906,1.338956952533976,77.16408917453305
13,13197,1311,38,2275,3624,36.175496688741724,62.77593818984547,1.0485651214128036,63.824503311258276
13,13199,4287,66,6524,10877,39.41344120621495,59.97977383469707,0.6067849590879838,60.58655879378505
13,13201,749,20,2066,2835,26.41975308641975,72.87477954144622,0.7054673721340388,73.58024691358025
13,13205,3995,33,4935,8963,44.57212986723195,55.05968983599241,0.3681802967756332,55.42787013276805
13,13207,4384,148,11060,15592,28.116983068240124,70.93381221139046,0.9492047203694202,71.88301693175987
13,13209,979,27,2960,3966,24.684820978315685,74.63439233484618,0.680786686838124,75.31517902168432
13,13211,3355,122,8230,11707,28.658067822670198,70.2998206201418,1.042111557188007,71.3419321773298
13,13213,2302,144,12943,15389,14.958736760023395,84.10552992397167,0.9357333160049386,85.0412632399766
13,13215,49529,965,30049,80543,61.49386042238307,37.3080218020188,1.1981177755981276,38.50613957761693
13,13217,29794,576,23869,54239,54.93095374177253,44.00707977654456,1.0619664816829217,45.06904625822747
13,13219,8162,411,16595,25168,32.430069930069934,65.93690400508582,1.6330260648442465,67.56993006993007
13,13221,2436,102,5593,8131,29.959414586151766,68.78612716763006,1.2544582462181775,70.04058541384823
13,13223,29704,1156,54525,85385,34.788311764361424,63.8578204602682,1.3538677753703812,65.21168823563858
13,13225,5920,123,6502,12545,47.19011558389797,51.82941410920685,0.9804703068951772,52.80988441610203
13,13227,2808,233,14075,17116,16.405702266884788,82.23299836410376,1.3612993690114512,83.59429773311521
13,13229,1100,49,7899,9048,12.157382847038019,87.30106100795756,0.5415561450044208,87.84261715296198
13,13231,1505,88,9127,10720,14.039179104477611,85.13992537313433,0.8208955223880596,85.96082089552239
13,13233,3658,152,13589,17399,21.024196792919135,78.1021897810219,0.8736134260589689,78.97580320708087
13,13235,1217,37,2805,4059,29.982754372998276,69.10569105691057,0.9115545700911556,70.01724562700173
13,13237,3448,116,8291,11855,29.084774356811472,69.9367355546183,0.9784900885702235,70.91522564318853
13,13239,497,5,604,1106,44.936708860759495,54.61121157323689,0.45207956600361665,55.063291139240505
13,13241,1984,110,7474,9568,20.735785953177256,78.11454849498328,1.1496655518394647,79.26421404682274
13,13243,1671,12,1391,3074,54.359141184124915,45.25048796356539,0.3903708523096942,45.640858815875085
13,13245,59124,1111,26781,87016,67.94612485060219,30.777098464650177,1.2767766847476327,32.05387514939781
13,13247,31244,430,13012,44686,69.91899028778589,29.11873965000224,0.9622700622118785,30.08100971221411
13,13249,462,13,1800,2275,20.307692307692307,79.12087912087912,0.5714285714285714,79.6923076923077
13,13251,2661,51,3916,6628,40.14785757392879,59.082679541339765,0.7694628847314424,59.85214242607121
13,13253,1254,19,2611,3884,32.286302780638515,67.22451081359424,0.48918640576725025,67.71369721936148
13,13255,11784,275,18057,30116,39.12870235090982,59.95816177447204,0.9131358746181432,60.87129764909018
13,13257,2385,132,9368,11885,20.06731173748422,78.82204459402608,1.1106436684896928,79.93268826251578
13,13259,1182,7,801,1990,59.39698492462312,40.25125628140703,0.35175879396984927,40.60301507537688
13,13261,6318,100,5732,12150,52,47.17695473251029,0.823045267489712,48
13,13263,2114,16,1392,3522,60.02271436683703,39.522998296422486,0.4542873367404884,39.97728563316297
13,13265,561,7,360,928,60.452586206896555,38.793103448275865,0.7543103448275862,39.547413793103445
13,13267,2061,69,6053,8183,25.186361969937675,73.97042649395087,0.8432115361114505,74.81363803006232
13,13269,1387,34,2418,3839,36.1292003125814,62.98515238343319,0.8856473039854129,63.8707996874186
13,13271,1487,21,2825,4333,34.318024463420265,65.19732287099006,0.48465266558966075,65.68197553657973
13,13273,2376,36,2004,4416,53.80434782608695,45.380434782608695,0.8152173913043478,46.19565217391305
13,13275,8708,191,12954,21853,39.848075779069234,59.277902347503776,0.8740218734269894,60.151924220930766
13,13277,5322,177,10784,16283,32.68439476754898,66.2285819566419,1.087023275809126,67.31560523245102
13,13279,2939,103,7872,10914,26.9287154113982,72.12754260582737,0.9437419827744181,73.0712845886018
13,13281,1550,45,6384,7979,19.425993232234614,80.0100263190876,0.5639804486777792,80.57400676776538
13,13283,952,24,2101,3077,30.939226519337016,68.28079298017549,0.7799805004874878,69.06077348066299
13,13285,11585,328,18146,30059,38.54086962307462,60.367943045344155,1.0911873315812237,61.45913037692538
13,13287,1410,33,2349,3792,37.18354430379747,61.94620253164557,0.870253164556962,62.81645569620253
13,13289,2044,30,2370,4444,45.994599459945995,53.33033303330333,0.6750675067506751,54.005400540054005
13,13291,2801,140,12651,15592,17.96434068753207,81.13776295536172,0.8978963571062083,82.03565931246793
13,13293,4201,96,8608,12905,32.55327392483534,66.70282836110036,0.7438977140643162,67.44672607516466
13,13295,5769,493,23174,29436,19.598450876477784,78.72672917515968,1.6748199483625492,80.40154912352222
13,13297,12682,571,37842,51095,24.820432527644584,74.06204129562579,1.1175261767296214,75.17956747235542
13,13299,4249,117,9930,14296,29.72160044767767,69.4599888080582,0.8184107442641299,70.27839955232233
13,13301,1488,16,1177,2681,55.501678478179784,43.901529280119355,0.5967922417008579,44.498321521820216
13,13303,4730,66,4663,9459,50.005285971032876,49.296965852627125,0.6977481763399936,49.994714028967124
13,13305,2687,104,9987,12778,21.028329942087964,78.15777116919705,0.813898888714979,78.97167005791204
13,13307,639,3,748,1390,45.97122302158274,53.81294964028777,0.2158273381294964,54.02877697841726
13,13309,689,13,1583,2285,30.153172866520787,69.27789934354486,0.5689277899343544,69.84682713347921
13,13311,2411,183,12222,14816,16.272948164146868,82.49190064794817,1.2351511879049677,83.72705183585313
13,13313,10670,440,25636,36746,29.037174114189302,69.76541664398846,1.197409241822239,70.9628258858107
13,13315,862,16,2403,3281,26.27247790307833,73.23986589454434,0.48765620237732393,73.72752209692167
13,13317,2159,47,2823,5029,42.93100019884669,56.13442036190097,0.9345794392523363,57.06899980115331
13,13319,2075,31,2664,4770,43.50104821802935,55.84905660377358,0.649895178197065,56.49895178197065
13,13321,2395,60,6831,9286,25.79151410725824,73.562351927633,0.6461339651087659,74.20848589274176
15,15001,58683,2182,26851,87716,66.90113548269416,30.611290984541018,2.487573532764832,33.09886451730584
15,15003,238869,6986,136259,382114,62.51249627074643,35.659253521200476,1.8282502080530942,37.48750372925357
15,15007,21217,690,11579,33486,63.36080750164248,34.578629875171714,2.060562623185809,36.63919249835752
15,15009,47301,1613,22111,71025,66.59767687434001,31.131291798662442,2.271031326997536,33.40232312565999
16,16001,120539,8151,130699,259389,46.47035919025094,50.387256205930086,3.1423846038189747,53.52964080974906
16,16003,591,54,1941,2586,22.8538283062645,75.05800464037124,2.088167053364269,77.1461716937355
16,16005,14682,1540,23331,39553,37.11981392056229,58.98667610547872,3.8935099739589916,62.88018607943771
16,16007,350,51,2914,3315,10.558069381598793,87.90346907993967,1.5384615384615385,89.4419306184012
16,16009,977,118,3878,4973,19.64608887995174,77.9810979288156,2.3728131912326567,80.35391112004825
16,16011,4124,675,15295,20094,20.523539364984572,76.11724893002886,3.359211704986563,79.47646063501543
16,16013,8919,338,4031,13288,67.1207104154124,30.33564118001204,2.5436484045755567,32.879289584587596
16,16015,1214,131,3495,4840,25.08264462809917,72.21074380165288,2.706611570247934,74.91735537190083
16,16017,8310,673,18369,27352,30.381690552793216,67.15779467680608,2.460514770400702,69.61830944720678
16,16019,14254,1936,37805,53995,26.398740624131868,70.0157421983517,3.585517177516437,73.60125937586812
16,16021,1220,156,4937,6313,19.325201964200854,78.20370663709805,2.471091398701093,80.67479803579914
16,16023,188,25,1202,1415,13.286219081272085,84.94699646643109,1.76678445229682,86.71378091872792
16,16025,149,98,507,754,19.76127320954907,67.24137931034483,12.9973474801061,80.23872679045093
16,16027,25881,2798,61759,90438,28.61739534266569,68.28877241867357,3.09383223866074,71.38260465733431
16,16029,431,79,2906,3416,12.617096018735364,85.07025761124122,2.3126463700234194,87.38290398126463
16,16031,1464,258,7907,9629,15.204071035413854,82.11652300342715,2.679405961158999,84.79592896458615
16,16033,41,6,264,311,13.183279742765272,84.88745980707395,1.929260450160772,86.81672025723472
16,16035,877,89,3453,4419,19.846119031455082,78.1398506449423,2.0140303236026247,80.15388096854491
16,16037,603,47,2089,2739,22.015334063526833,76.26871120847024,1.7159547280029208,77.98466593647316
16,16039,2601,358,7246,10205,25.4875061244488,71.00440960313573,3.508084272415483,74.5124938755512
16,16041,657,162,5845,6664,9.858943577430972,87.71008403361344,2.430972388955582,90.14105642256902
16,16043,998,173,5548,6719,14.853400803691025,82.57181128144069,2.574787914868284,85.14659919630897
16,16045,1803,204,7951,9958,18.10604539064069,79.84535047198233,2.0486041373769837,81.89395460935931
16,16047,1256,135,4659,6050,20.760330578512395,77.00826446280992,2.231404958677686,79.2396694214876
16,16049,1561,215,7826,9602,16.257029785461363,81.50385336388253,2.239116850656113,83.74297021453864
16,16051,1661,413,12099,14173,11.719466591406196,85.36654201651027,2.913991392083539,88.28053340859381
16,16053,1893,185,5734,7812,24.23195084485407,73.39989759344598,2.3681515616999484,75.76804915514593
16,16055,24312,2729,62837,89878,27.050001112619327,69.91366074011438,3.036338147266294,72.94999888738067
16,16057,10236,862,9472,20570,49.76178901312591,46.04764219737481,4.190568789499271,50.23821098687409
16,16059,1032,114,3592,4738,21.78134233853947,75.81257914731955,2.406078514140988,78.21865766146053
16,16061,349,32,1489,1870,18.663101604278076,79.62566844919786,1.7112299465240641,81.33689839572193
16,16063,414,57,1469,1940,21.34020618556701,75.72164948453607,2.938144329896907,78.65979381443299
16,16065,2666,887,13559,17112,15.579710144927535,79.23679289387564,5.183496961196821,84.42028985507247
16,16067,1550,178,6265,7993,19.39196797197548,78.38108344801702,2.2269485800075066,80.60803202802452
16,16069,6686,543,13738,20967,31.888205274955883,65.52201077884294,2.589783946201173,68.11179472504412
16,16071,249,54,2148,2451,10.159118727050185,87.63769889840881,2.203182374541004,89.84088127294982
16,16073,816,107,3819,4742,17.207929143821172,80.53563897089836,2.256431885280472,82.79207085617882
16,16075,2161,270,8862,11293,19.13574780837687,78.4733905959444,2.390861595678739,80.86425219162314
16,16077,865,105,2116,3086,28.0298120544394,68.56772521062865,3.4024627349319507,71.9701879455606
16,16079,1693,140,4216,6049,27.988097206149774,69.69747065630682,2.314432137543396,72.01190279385023
16,16081,3318,171,2858,6347,52.276666141484164,45.029147628801006,2.6941862297148256,47.723333858515836
16,16083,9391,1392,25897,36680,25.602508178844058,70.60250817884406,3.7949836423118866,74.39749182115594
16,16085,2976,140,3947,7063,42.13507008353391,55.882769361461136,1.9821605550049552,57.86492991646609
16,16087,1073,117,4154,5344,20.07859281437126,77.73203592814372,2.1893712574850297,79.92140718562874
17,17001,8569,734,24131,33434,25.629598612191185,72.17503140515643,2.19536998265239,74.37040138780881
17,17003,1114,25,1486,2625,42.43809523809524,56.60952380952381,0.9523809523809524,57.56190476190476
17,17005,2275,222,5612,8109,28.055247256135157,69.20705389073869,2.737698853126156,71.94475274386484
17,17007,10372,538,13762,24672,42.039559014267184,55.779831387808045,2.180609597924773,57.960440985732816
17,17009,485,108,1930,2523,19.223147047166073,76.49623464130005,4.280618311533888,80.77685295283393
17,17011,6545,341,10296,17182,38.0921895006402,59.92317541613317,1.9846350832266324,61.9078104993598
17,17013,674,50,2043,2767,24.358511022768344,73.8344777737622,1.8070112034694614,75.64148897723166
17,17015,2737,171,5098,8006,34.18685985510867,63.677242068448656,2.1358980764426683,65.81314014489132
17,17017,1615,86,3624,5325,30.328638497652584,68.05633802816902,1.6150234741784035,69.67136150234742
17,17019,56596,3193,35122,94911,59.630601300165424,37.005194339960596,3.3642043598739875,40.369398699834576
17,17021,4286,303,11505,16094,26.631042624580587,71.48626817447496,1.8826892009444514,73.36895737541941
17,17023,1990,135,6215,8340,23.860911270983213,74.52038369304557,1.618705035971223,76.13908872901679
17,17025,1129,141,5626,6896,16.371809744779583,81.58352668213456,2.0446635730858467,83.62819025522042
17,17027,4459,416,14264,19139,23.297977950781128,74.52844976226554,2.173572286953341,76.70202204921887
17,17029,7997,492,13981,22470,35.5896751223854,62.22073876279484,2.1895861148197597,64.4103248776146
17,17031,2432354,54107,914300,3400761,71.52381481674249,26.88515893942562,1.5910262438318952,28.476185183257513
17,17033,2198,196,7025,9419,23.335810595604627,74.58328909650706,2.0809003078883106,76.66418940439537
17,17035,1141,107,4595,5843,19.52763991100462,78.64110901933938,1.8312510696559987,80.47236008899537
17,17037,24484,1415,21818,47717,51.31085357419788,45.72374625395561,2.9654001718465115,48.68914642580212
17,17039,2171,200,5623,7994,27.157868401300977,70.34025519139354,2.501876407305479,72.84213159869903
17,17041,2327,198,6221,8746,26.606448662245597,71.12965927281043,2.2638920649439744,73.3935513377544
17,17043,281222,10231,193611,485064,57.976267049296595,39.9145267428628,2.109206207840615,42.023732950703405
17,17045,1869,114,6169,8152,22.926889106967614,75.67468105986262,1.3984298331697742,77.07311089303238
17,17047,488,47,2833,3368,14.489311163895488,84.11520190023754,1.3954869358669832,85.5106888361045
17,17049,3700,358,14983,19041,19.431752534005568,78.68809411270416,1.8801533532902683,80.56824746599443
17,17051,1815,193,8025,10033,18.090302003388818,79.98604604804146,1.9236519485697199,81.90969799661119
17,17053,1691,162,4956,6809,24.83477750036716,72.78601850491995,2.37920399471288,75.16522249963285
17,17055,4690,284,13514,18488,25.367806144526178,73.09606231068801,1.536131544785807,74.63219385547382
17,17057,6371,348,9798,16517,38.5723799721499,59.320699884967,2.10692014288309,61.4276200278501
17,17059,621,33,2019,2673,23.232323232323232,75.5331088664422,1.2345679012345678,76.76767676767676
17,17061,1349,108,4767,6224,21.674164524421595,76.59061696658098,1.7352185089974295,78.3258354755784
17,17063,9445,583,16372,26400,35.776515151515156,62.015151515151516,2.2083333333333335,64.22348484848484
17,17065,821,66,3429,4316,19.02224281742354,79.44856348470807,1.5291936978683967,80.97775718257645
17,17067,1114,142,5309,6565,16.96877380045697,80.86824067022087,2.162985529322163,83.03122619954303
17,17071,1186,75,2391,3652,32.47535596933187,65.4709748083242,2.0536692223439212,67.52464403066813
17,17073,9762,596,15266,25624,38.097096472057444,59.57695910084296,2.325944427099594,61.902903527942556
17,17075,2895,258,10858,14011,20.66233673542217,77.49625294411534,1.8414103204624936,79.33766326457783
17,17077,11104,636,10835,22575,49.18715393133998,47.99557032115172,2.8172757475083055,50.81284606866002
17,17079,1006,84,4492,5582,18.022214260121817,80.4729487638839,1.5048369759942675,81.97778573987819
17,17081,4597,351,12461,17409,26.405882015049688,71.57791946694239,2.016198518007927,73.59411798495032
17,17083,2956,287,8699,11942,24.752972701390053,72.84374476637079,2.4032825322391558,75.24702729860995
17,17085,5097,219,7161,12477,40.8511661457081,57.39360423178649,1.7552296225054098,59.1488338542919
17,17087,1280,110,5052,6442,19.869605712511643,78.4228500465694,1.7075442409189692,80.13039428748836
17,17089,130166,4935,96775,231876,56.1360382273284,41.735669064499994,2.128292708171609,43.8639617726716
17,17091,20112,1207,28410,49729,40.44320215568381,57.12964266323473,2.4271551810814618,59.55679784431619
17,17093,31394,1418,28515,61327,51.19115560845957,46.49664911050598,2.312195281034455,48.80884439154043
17,17095,10421,477,11818,22716,45.8751540764219,52.025004402183484,2.0998415213946116,54.1248459235781
17,17097,199383,6370,121805,327558,60.86952539702892,37.18578083881328,1.944693764157798,39.13047460297108
17,17099,21491,1080,29482,52053,41.28676541217605,56.638426219430194,2.0748083683937524,58.71323458782395
17,17101,1414,116,4849,6379,22.166483774886345,76.01504938078068,1.8184668443329677,77.83351622511366
17,17103,6368,399,9584,16351,38.945630236682774,58.61415203963061,2.4402177236866245,61.054369763317226
17,17105,4568,347,12134,17049,26.793360314387943,71.17132969675642,2.0353099888556514,73.20663968561206
17,17107,3769,306,9042,13117,28.733704353129525,68.93344514751848,2.332850499351986,71.26629564687047
17,17109,4973,308,7009,12290,40.463791700569566,57.030105777054516,2.5061025223759152,59.536208299430434
17,17111,77208,4079,81479,162766,47.43496799085804,50.05898037673716,2.506051632404802,52.56503200914196
17,17113,43719,2929,40365,87013,50.24421638146024,46.38961994184777,3.3661636766919885,49.75578361853976
17,17115,19633,928,28373,48934,40.12138799198921,57.982180079290465,1.896431928720317,59.87861200801079
17,17117,7313,548,16058,23919,30.574020653037337,67.13491366695932,2.291065680003345,69.42597934696266
17,17119,56845,3569,75272,135686,41.894521173886766,55.475141134678594,2.6303376914346357,58.105478826113234
17,17121,4396,278,12540,17214,25.537353317067502,72.84768211920529,1.614964563727199,74.4626466829325
17,17123,2004,143,4196,6343,31.593883020652687,66.15166325082768,2.254453728519628,68.40611697934732
17,17125,1984,127,4645,6756,29.366489046773236,68.75370041444641,1.8798105387803434,70.63351095322676
17,17127,1719,95,4989,6803,25.26826400117595,73.33529325297663,1.3964427458474202,74.73173599882405
17,17129,2022,168,4764,6954,29.076790336496984,68.50733390854185,2.4158757549611733,70.92320966350302
17,17131,3212,210,5328,8750,36.70857142857143,60.89142857142858,2.4,63.29142857142857
17,17133,6489,489,14046,21024,30.86472602739726,66.8093607305936,2.3259132420091326,69.13527397260273
17,17135,3889,308,9504,13701,28.384789431428363,69.36719947449092,2.248011094080724,71.61521056857164
17,17137,5020,306,9903,15229,32.96342504432333,65.02725064022589,2.009324315450785,67.03657495567667
17,17139,1645,115,4938,6698,24.55957002090176,73.72349955210511,1.7169304269931325,75.44042997909824
17,17141,9300,648,16092,26040,35.714285714285715,61.79723502304147,2.488479262672811,64.28571428571428
17,17143,42600,2052,37612,82264,51.78449868715356,45.72109306622581,2.4944082466206363,48.21550131284644
17,17145,2609,146,7305,10060,25.93439363817097,72.61431411530815,1.4512922465208749,74.06560636182903
17,17147,3302,270,6219,9791,33.72484935144521,63.51751608620161,2.7576345623531817,66.275150648554785
17,17149,1458,143,6235,7836,18.60643185298622,79.56865747830525,1.8249106687085248,81.39356814701378
17,17151,432,20,1720,2172,19.88950276243094,79.18968692449356,0.9208103130755065,80.11049723756906
17,17153,891,41,1699,2631,33.8654503990878,64.57620676548841,1.5583428354237931,66.13454960091221
17,17155,1309,58,1978,3345,39.13303437967115,59.133034379671145,1.7339312406576979,60.86696562032885
17,17157,3590,241,11065,14896,24.10042964554243,74.28168635875403,1.6178839957035445,75.89957035445757
17,17159,1355,0,7988,9343,14.50283634806807,85.49716365193193,0,85.49716365193193
17,17161,36647,1518,28585,66750,54.901872659176036,42.823970037453186,2.2741573033707865,45.098127340823964
17,17163,66698,2522,56000,125220,53.26465420859287,44.72129052866954,2.014055262737582,46.73534579140713
17,17165,2786,197,8096,11079,25.146673887534977,73.07518729127177,1.7781388211932485,74.85332611246503
17,17167,48756,2336,53303,104395,46.70338617749892,51.058958762392834,2.237655060108243,53.29661382250108
17,17169,1064,77,2767,3908,27.226202661207775,70.80348004094165,1.970317297850563,72.77379733879222
17,17171,569,57,2104,2730,20.842490842490843,77.06959706959708,2.0879120879120876,79.15750915750915
17,17173,2488,165,9396,12049,20.649016515893432,77.98157523445929,1.3694082496472737,79.35098348410656
17,17175,814,67,2000,2881,28.254078444984383,69.42034015966678,2.3255813953488373,71.74592155501561
17,17177,8756,437,12253,21446,40.82812645714819,57.13419751935093,2.037676023500886,59.17187354285181
17,17179,24486,1678,42194,68358,35.82024049855174,61.725035840720906,2.454723660727347,64.17975950144826
17,17181,2575,164,6157,8896,28.94559352517986,69.21088129496404,1.8435251798561152,71.05440647482014
17,17183,10313,594,20710,31617,32.6185280070848,65.50273586994338,1.8787361229718187,67.38147199291521
17,17185,1248,116,4228,5592,22.317596566523605,75.60801144492132,2.074391988555079,77.6824034334764
17,17187,3087,158,4671,7916,38.99696816574028,59.00707427993937,1.9959575543203638,61.00303183425972
17,17189,1639,165,6110,7914,20.710133939853424,77.20495324740966,2.0849128127369223,79.28986606014658
17,17191,1185,135,7172,8492,13.954309938765896,84.4559585492228,1.5897315120113047,86.0456900612341
17,17193,1517,123,5788,7428,20.42272482498654,77.92137856758212,1.6558966074313408,79.57727517501345
17,17195,12195,587,14472,27254,44.7457253981067,53.10046231745799,2.153812284435312,55.2542746018933
17,17197,182957,7123,154351,344431,53.11862172684805,44.81332981061519,2.0680484625367637,46.88137827315195
17,17199,10107,715,22681,33503,30.16744769125153,67.69841506730741,2.134137241441065,69.83255230874846
17,17201,60601,2585,58796,121982,49.68028069715204,48.20055418012494,2.119165122723025,50.31971930284796
17,17203,5976,513,14590,21079,28.350491010009964,69.21580720148015,2.4337017885098913,71.64950898999004
18,18001,3236,317,10685,14238,22.727911223486444,75.0456524792808,2.2264362972327576,77.27208877651356
18,18003,73189,3728,92083,169000,43.30710059171597,54.48698224852071,2.2059171597633136,56.69289940828403
18,18005,12934,956,22409,36299,35.63183558775724,61.73448304361002,2.6336813686327445,64.36816441224276
18,18007,1009,99,3007,4115,24.520048602673146,73.07411907654921,2.405832320777643,75.47995139732686
18,18009,1376,140,3838,5354,25.700410907732536,71.68472170339932,2.6148673888681357,74.29958909226747
18,18011,15244,905,22351,38500,39.5948051948052,58.05454545454546,2.3506493506493507,60.4051948051948
18,18013,2996,165,5725,8886,33.71595768624803,64.42718883637181,1.8568534773801486,66.28404231375197
18,18015,2224,204,7086,9514,23.376077359680473,74.4797141055287,2.1442085347908346,76.62392264031953
18,18017,4304,333,10552,15189,28.33629600368688,69.47132793468957,2.1923760616235435,71.66370399631312
18,18019,23088,1296,33656,58040,39.77946243969676,57.987594762232945,2.232942798070296,60.22053756030324
18,18021,2549,230,9498,12277,20.76240123808748,77.36417691618473,1.8734218457277838,79.23759876191252
18,18023,3361,266,9334,12961,25.931641077077387,72.0160481444333,2.052310778489314,74.06835892292261
18,18025,1369,107,3499,4975,27.51758793969849,70.33165829145729,2.150753768844221,72.48241206030151
18,18027,2169,226,9576,11971,18.11878706874948,79.99331718319272,1.8878957480578065,81.88121293125052
18,18029,5446,387,19528,25361,21.47391664366547,77.00011829186546,1.5259650644690668,78.52608335633454
18,18031,2436,290,9570,12296,19.81132075471698,77.83018867924528,2.358490566037736,80.18867924528303
18,18033,4966,453,14237,19656,25.264550264550266,72.43080993080994,2.304639804639805,74.73544973544973
18,18035,20474,890,26827,48191,42.485111327841295,55.66807080160196,1.8468178705567428,57.514888672158705
18,18037,6292,481,15032,21805,28.85576702591149,68.93831689979363,2.2059160742948865,71.14423297408851
18,18039,26108,1241,46972,74321,35.1286984836049,63.20151774061167,1.6697837757834262,64.8713015163951
18,18041,2237,154,7755,10146,22.048097772521192,76.4340626848019,1.517839542676917,77.95190222747881
18,18043,17511,850,23400,41761,41.931467158353485,56.03314096884653,2.035391872799981,58.068532841646515
18,18045,1629,200,6154,7983,20.40586245772266,77.0888137291745,2.5053238131028435,79.59413754227734
18,18047,2137,190,9691,12018,17.78166084207023,80.63737726743219,1.580961890497587,82.21833915792976
18,18049,2280,170,6694,9144,24.93438320209974,73.20647419072615,1.859142607174103,75.06561679790026
18,18051,4027,321,11817,16165,24.911846582121868,73.1023816888339,1.9857717290442314,75.08815341787813
18,18053,8015,672,18543,27230,29.43444730077121,68.09768637532133,2.467866323907455,70.56555269922879
18,18055,3389,290,11103,14782,22.92653226897578,75.11162224326884,1.961845487755378,77.07346773102422
18,18057,88390,3894,101587,193871,45.59217211444724,52.39927580710885,2.008552078443914,54.40782788555276
18,18059,12895,1016,28996,42907,30.053371244785232,67.57871675950311,2.3679119957116557,69.94662875521476
18,18061,5343,323,14565,20231,26.409964905343287,71.99347535959666,1.5965597350600564,73.59003509465671
18,18063,32604,2052,53802,88458,36.85816997897307,60.822085057315334,2.319744963711592,63.14183002102693
18,18065,5544,434,15043,21021,26.373626373626376,71.56177156177156,2.064602064602065,73.62637362637362
18,18067,13270,949,26400,40619,32.6694404096605,64.99421453014598,2.3363450601935054,67.3305595903395
18,18069,4255,408,13147,17810,23.891072431218415,73.81807973048849,2.2908478382930935,76.10892756878158
18,18071,4302,381,14555,19238,22.361991891048966,75.65755276016219,1.9804553487888554,77.63800810895103
18,18073,3798,314,11383,15495,24.511132623426914,73.4624072281381,2.026460148434979,75.48886737657308
18,18075,1926,179,6361,8466,22.749822820694543,75.13583746751713,2.11433971178833,77.25017717930545
18,18077,4731,335,9659,14725,32.12903225806451,65.59592529711375,2.275042444821732,67.87096774193549
18,18079,2523,238,9490,12251,20.594237205126113,77.4630642396539,1.942698555219982,79.40576279487388
18,18081,24729,1846,51209,77784,31.791885220610922,65.8348760670575,2.3732387123315846,68.20811477938908
18,18083,4067,306,11654,16027,25.375928121295317,72.71479378548699,1.909278093217695,74.62407187870468
18,18085,8350,1020,26476,35846,23.294091390950175,73.86040283434693,2.845505774702896,76.70590860904983
18,18087,2355,168,8110,10633,22.148029718799965,76.27198344775698,1.5799868334430547,77.85197028120004
18,18089,124801,3699,91733,220233,56.667711015152136,41.65270418148052,1.6795848033673426,43.332288984847864
18,18091,22419,1059,25991,49469,45.31929086902909,52.53997452950333,2.1407346014675857,54.68070913097091
18,18093,4961,509,15601,21071,23.544207678800248,74.04014996915191,2.415642352047838,76.45579232119975
18,18095,19524,1026,31215,51765,37.71660388293248,60.30136192407998,1.9820341929875398,62.28339611706752
18,18097,247265,9172,133968,390405,63.33551055954714,34.31513428362854,2.3493551568243234,36.66448944045286
18,18099,5712,362,13844,19918,28.677578070087357,69.50497037855207,1.8174515513605785,71.32242192991265
18,18101,1011,115,4029,5155,19.612027158098932,78.15712900096993,2.2308438409311346,80.38797284190107
18,18103,3235,333,10925,14493,22.321120540950805,75.38121851928517,2.297660939764024,77.6788794590492
18,18105,39861,1105,22071,63037,63.234290971968846,35.01277027777337,1.7529387502577851,36.765709028031154
18,18107,4213,326,12659,17198,24.49703453889987,73.6073962088615,1.8955692522386325,75.50296546110013
18,18109,7777,927,27510,36214,21.47512011929088,75.965096371569,2.5597835091401113,78.52487988070912
18,18111,1509,140,4942,6591,22.894856622667273,74.98103474434835,2.124108632984373,77.10514337733272
18,18113,4660,362,14195,19217,24.249362543581203,73.86688869230369,1.8837487641151063,75.7506374564188
18,18115,750,22,2392,3164,23.70417193426043,75.60050568900127,0.695322376738306,76.29582806573957
18,18117,2224,174,6432,8830,25.18686296715742,72.84258210645527,1.9705549263873159,74.81313703284258
18,18119,2419,211,7285,9915,24.397377710539587,73.4745335350479,2.1280887544125062,75.60262228946041
18,18121,1503,119,5398,7020,21.41025641025641,76.8945868945869,1.6951566951566952,78.58974358974359
18,18123,3202,189,5343,8734,36.66132356308679,61.174719487062056,2.163956949851156,63.33867643691321
18,18125,1415,113,4692,6220,22.7491961414791,75.43408360128618,1.8167202572347267,77.2508038585209
18,18127,39746,1656,45008,86410,45.99699108899433,52.086564055086214,1.9164448559194538,54.00300891100567
18,18129,3811,247,9206,13264,28.73190591073583,69.4059107358263,1.862183353437877,71.26809408926417
18,18131,1463,104,4246,5813,25.1677275073112,73.04317908136935,1.7890934113194565,74.8322724926888
18,18133,3946,371,12278,16595,23.77824645977704,73.98614040373607,2.2356131364868936,76.22175354022296
18,18135,2512,254,8312,11078,22.67557320816032,75.0315941505687,2.2928326412709876,77.32442679183968
18,18137,2774,229,11261,14264,19.4475602916433,78.9469994391475,1.605440269209198,80.5524397083567
18,18139,1754,143,6035,7932,22.11296016137166,76.08421583459405,1.8028240040342913,77.88703983862834
18,18141,59870,2525,53152,115547,51.81441318251447,46.00032887050291,2.1852579469826128,48.18558681748553
18,18143,2698,150,7328,10176,26.513364779874216,72.0125786163522,1.474056603773585,73.48663522012578
18,18145,5023,426,14568,20017,25.093670380176853,72.77813858220512,2.128191037618025,74.90632961982314
18,18147,3208,219,7354,10781,29.756052314256564,68.21259623411558,2.031351451627864,70.24394768574344
18,18149,2650,193,7466,10309,25.705694053739453,72.42215539819576,1.872150548064798,74.29430594626055
18,18151,4509,344,11322,16175,27.87635239567233,69.9969088098918,2.126738794435858,72.12364760432767
18,18153,2153,164,6687,9004,23.911594846734786,74.26699244780097,1.8214127054642382,76.08840515326521
18,18155,964,55,3133,4152,23.21772639691715,75.45761078998073,1.3246628131021194,76.78227360308284
18,18157,35017,1832,34581,71430,49.022819543609124,48.41243175136497,2.5647487050258997,50.977180456390876
18,18159,1834,180,6110,8124,22.575086164451008,75.20925652387986,2.2156573116691285,77.42491383554899
18,18161,736,68,2687,3491,21.082784302492122,76.96934975651676,1.94786594099112,78.91721569750788
18,18163,34415,1322,41844,77581,44.36008816591691,53.935886363929306,1.704025470153775,55.63991183408309
18,18165,2145,151,5184,7480,28.676470588235293,69.30481283422459,2.018716577540107,71.32352941176471
18,18167,18080,1001,24512,43593,41.47454866607024,56.22921111187576,2.2962402220539997,58.52545133392976
18,18169,3494,342,10762,14598,23.93478558706672,73.722427729826,2.342786683107275,76.06521441293327
18,18171,974,98,3401,4473,21.775095014531633,76.03398166778449,2.190923317683881,78.22490498546837
18,18173,11919,641,21324,33884,35.17589422736395,62.93235745484594,1.8917483177901075,64.82410577263605
18,18175,2784,233,9114,12131,22.949468304344244,75.12983266012695,1.9206990355288105,77.05053169565576
18,18177,9524,571,17567,27662,34.42990383920179,63.50589256019088,2.0642036006073314,65.57009616079822
18,18179,2928,297,10855,14080,20.795454545454543,77.09517045454545,2.109375,79.20454545454545
18,18181,3032,170,7957,11159,27.1708934492338,71.30567255130387,1.5234339994623174,72.8291065507662
18,18183,4233,492,12856,17581,24.07712871850293,73.12439565439963,2.7984756270974347,75.92287128149707
19,19001,1197,69,2917,4183,28.615825962228065,69.73464021037533,1.6495338273966054,71.38417403777194
19,19003,590,40,1528,2158,27.340129749768305,70.80630213160333,1.8535681186283595,72.65987025023169
19,19005,2575,151,4733,7459,34.522053894623944,63.45354605174956,2.0244000536264917,65.47794610537605
19,19007,1891,103,4512,6506,29.065478020288964,69.3513679680295,1.5831540116815246,70.93452197971104
19,19009,1071,50,2295,3416,31.352459016393443,67.18384074941453,1.4637002341920375,68.64754098360656
19,19011,5156,292,9179,14627,35.24988035824161,62.75381144458877,1.996308197169618,64.75011964175839
19,19013,35621,1305,29623,66549,53.52597334295031,44.51306556071466,1.9609610963350312,46.47402665704969
19,19015,6303,308,8695,15306,41.17992943943551,56.8077877956357,2.0122827649287864,58.82007056056449
19,19017,5954,293,8287,14534,40.9660107334526,57.018026696023114,2.015962570524288,59.0339892665474
19,19019,4169,175,6420,10764,38.73095503530286,59.643255295429206,1.6257896692679301,61.26904496469714
19,19021,2961,132,5056,8149,36.33574671738863,62.04442262854338,1.6198306540679837,63.66425328261137
19,19023,2424,118,5542,8084,29.985155863433942,68.55517070757051,1.4596734289955469,70.01484413656605
19,19025,1470,90,3689,5249,28.005334349399885,70.280053343494,1.7146123071061157,71.99466565060011
19,19027,3454,115,7737,11306,30.550150362639307,68.43269060675748,1.0171590306032197,69.4498496373607
19,19029,2201,96,4969,7266,30.29176988714561,68.38700798238371,1.3212221304706853,69.7082301128544
19,19031,4337,205,6161,10703,40.52134915444268,57.56330000934318,1.9153508362141456,59.47865084555732
19,19033,10941,418,12435,23794,45.98218038160881,52.26107422039169,1.7567453979994956,54.01781961839119
19,19035,1936,72,4495,6503,29.7708749807781,69.12194371828387,1.1071813009380287,70.2291250192219
19,19037,2233,76,4308,6617,33.746410760163215,65.1050324920659,1.1485567477708931,66.25358923983678
19,19039,1466,60,3140,4666,31.41877411058723,67.29532790398628,1.2858979854264894,68.58122588941276
19,19041,2662,149,6137,8948,29.749664729548503,68.58515869468037,1.6651765757711219,70.2503352704515
19,19043,3340,135,6106,9581,34.86066172633337,63.73029955119507,1.4090387224715581,65.13933827366662
19,19045,10806,514,13349,24669,43.803964489845555,54.11244882240869,2.083586687745754,56.196035510154445
19,19047,2220,72,4854,7146,31.066330814441645,67.92611251049539,1.0075566750629723,68.93366918555836
19,19049,26879,981,27987,55847,48.12971153329633,50.113703511379306,1.7565849553243684,51.87028846670367
19,19051,1013,54,3032,4099,24.713344718223958,73.96926079531593,1.3173944864601121,75.28665528177604
19,19053,1120,66,2615,3801,29.46593001841621,68.79768481978427,1.7363851617995265,70.5340699815838
19,19055,3157,158,6666,9981,31.630097184650836,66.78689510069131,1.58300771465785,68.36990281534916
19,19057,8887,471,10589,19947,44.55306562390334,53.08567704416704,2.3612573319296137,55.44693437609666
19,19059,3661,131,7438,11230,32.600178094390024,66.233303650935,1.1665182546749777,67.39982190560997
19,19061,25655,1055,27214,53924,47.57621838142571,50.467324382464206,1.9564572361100807,52.42378161857429
19,19063,1520,65,3265,4850,31.34020618556701,67.31958762886599,1.3402061855670102,68.65979381443299
19,19065,3834,205,6145,10184,37.64728986645719,60.339748625294575,2.0129615082482326,62.35271013354281
19,19067,3168,128,4730,8026,39.47171692000997,58.93346623473711,1.594816845252928,60.52828307999003
19,19069,1626,71,3422,5119,31.76401640945497,66.8489939441297,1.3869896464153155,68.23598359054503
19,19071,1078,66,2711,3855,27.963683527885863,70.3242542153048,1.7120622568093387,72.03631647211414
19,19073,1768,65,3221,5054,34.98219232291254,63.73169766521567,1.2861100118717848,65.01780767708746
19,19075,2206,125,4929,7260,30.385674931129476,67.89256198347108,1.721763085399449,69.61432506887053
19,19077,1985,112,4272,6369,31.166588161406818,67.0748940178992,1.7585178206939864,68.83341183859318
19,19079,2842,718,4956,8516,33.37247534053546,58.196336308125886,8.431188351338657,66.62752465946454
19,19081,1683,88,4390,6161,27.316993994481415,71.25466645025158,1.4283395552670022,72.68300600551859
19,19083,2976,149,5850,8975,33.15877437325906,65.18105849582173,1.66016713091922,66.84122562674094
19,19085,2440,135,5569,8144,29.960707269155208,68.38163064833006,1.6576620825147346,70.03929273084479
19,19087,3275,182,6507,9964,32.86832597350461,65.30509835407466,1.8265756724207147,67.13167402649539
19,19089,1772,53,3127,4952,35.78352180936995,63.14620355411955,1.0702746365105007,64.21647819063006
19,19091,1442,60,3819,5321,27.100169141138885,71.77222326630333,1.12760759255779,72.89983085886112
19,19093,917,52,2876,3845,23.849154746423928,74.79843953185956,1.3524057217165149,76.15084525357608
19,19095,3547,160,6009,9716,36.506792918896664,61.84643886372992,1.6467682173734046,63.493207081103336
19,19097,4029,149,6940,11118,36.23853211009174,62.42129879474726,1.3401690951610001,63.76146788990826
19,19099,7737,362,12082,20181,38.338040731381,59.86819285466528,1.793766413953719,61.661959268619
19,19101,4314,196,4442,8952,48.19034852546917,49.62019660411081,2.189454870420018,51.80965147453083
19,19103,59177,1468,22925,83570,70.81129591958837,27.432092856288143,1.7566112241234892,29.188704080411625
19,19105,4213,180,6572,10965,38.42225262197903,59.93616051071592,1.6415868673050615,61.57774737802097
19,19107,1414,80,3797,5291,26.724626724626727,71.76337176337177,1.512001512001512,73.27537327537327
19,19109,2696,106,6275,9077,29.701443208108408,69.13077007821967,1.167786713671918,70.2985567918916
19,19111,6539,419,9763,16721,39.1065127683751,58.38765624065546,2.50583099096944,60.8934872316249
19,19113,70874,2840,53364,127078,55.77204551535277,41.993106595948944,2.2348478886982797,44.22795448464723
19,19115,1726,100,3500,5326,32.40705970709726,65.71535861809988,1.877581674802854,67.59294029290274
19,19117,1284,59,3287,4630,27.73218142548596,70.99352051835854,1.2742980561555075,72.26781857451404
19,19119,1067,78,5707,6852,15.572095738470521,83.289550496205493,1.138353765323993,84.42790426152948
19,19121,3134,165,6507,9806,31.960024474811338,66.35733224556394,1.6826432796247195,68.03997552518867
19,19123,2894,190,8297,11381,25.42834548809419,72.90220543010281,1.669449081803005,74.5716545119058
19,19125,6170,390,12657,19217,32.10698860384035,65.86355830774835,2.0294530884113025,67.89301139615965
19,19127,8171,387,9564,18122,45.088842291137844,52.77563182871647,2.1355258801456793,54.911157708862156
19,19129,2500,175,5572,8247,30.314053595246754,67.56396265308598,2.121983751667273,69.68594640475325
19,19131,2053,85,3677,5815,35.30524505588994,63.23301805674979,1.4617368873602752,64.69475494411006
19,19133,1407,59,3248,4714,29.84726347051336,68.90114552397115,1.2515910055154857,70.15273652948665
19,19135,1078,32,2975,4085,26.389228886168908,72.82741738066095,0.7833537331701347,73.61077111383109
19,19137,1583,78,3659,5320,29.755639097744364,68.7781954887218,1.4661654135338347,70.24436090225564
19,19139,9372,434,10823,20629,45.43118910271947,52.46497648940811,2.1038344078724123,54.56881089728053
19,19141,1569,111,5861,7541,20.80625911682801,77.7217875613314,1.4719533218406047,79.19374088317198
19,19143,600,37,2688,3325,18.045112781954884,80.84210526315789,1.1127819548872182,81.95488721804512
19,19145,2086,114,5319,7519,27.743050937624687,70.74078999867004,1.51615906370528,72.25694906237531
19,19147,1519,61,3370,4950,30.686868686868685,68.08080808080808,1.2323232323232323,69.31313131313132
19,19149,3494,179,10492,14165,24.6664313448641,74.06989057536181,1.263678079774091,75.3335686551359
19,19151,932,64,2825,3821,24.391520544360116,73.9335252551688,1.6749542004710807,75.60847945563988
19,19153,146250,4941,106800,257991,56.68802400083723,41.39679291138063,1.915183087782132,43.31197599916277
19,19155,18570,922,26241,45733,40.60525222487044,57.37869809546717,2.0160496796623883,59.39474777512956
19,19157,4306,161,5657,10124,42.53259581193205,55.87712366653497,1.590280521532991,57.46740418806795
19,19159,708,37,1964,2709,26.135105204872644,72.49907715023994,1.3658176448874122,73.86489479512736
19,19161,1389,77,4061,5527,25.131174235570835,73.47566491767687,1.393160846752307,74.86882576442916
19,19163,46890,2088,43661,92639,50.615831345329724,47.13025831453276,2.253910340137523,49.384168654670276
19,19165,1959,125,4697,6781,28.88954431499779,69.26706975372365,1.8433859312785725,71.11045568500221
19,19167,3019,257,15680,18956,15.92635577125976,82.7178729689808,1.355771259759443,84.07364422874024
19,19169,29175,1322,20340,50837,57.38930306666404,40.010228770383776,2.6004681629521804,42.61069693333596
19,19171,3577,146,5303,9026,39.62995789940173,58.752492798581876,1.6175493020163971,60.37004210059827
19,19173,746,33,2463,3242,23.010487353485505,75.97162245527453,1.0178901912399754,76.9895126465145
19,19175,2061,100,4010,6171,33.398152649489546,64.98136444660508,1.6204829039053639,66.60184735051045
19,19177,875,54,2859,3788,23.09926082365364,75.47518479408659,1.4255543822597676,76.90073917634636
19,19179,5821,276,9516,15613,37.28303336962787,60.94920899250624,1.767757637865881,62.71696663037213
19,19181,12537,680,17738,30955,40.50072686157325,57.302535939266676,2.1967371991600713,59.49927313842675
19,19183,4558,233,6966,11757,38.76839329760993,59.24980862464915,1.98179807774092,61.23160670239007
19,19185,727,38,2338,3103,23.428939735739608,75.34643893006768,1.2246213341927168,76.5710602642604
19,19187,6604,271,10927,17802,37.09695539826986,61.38074373665881,1.5223008650713403,62.90304460173014
19,19189,2135,109,3707,5951,35.876323307007226,62.292051756007396,1.8316249369853808,64.12367669299277
19,19191,5617,184,6235,12036,46.66832834828847,51.80292455965437,1.5287470920571617,53.33167165171153
19,19193,18704,732,25736,45172,41.40618081997698,56.973346320729654,1.6204728592933675,58.59381918002302
19,19195,1596,80,2738,4414,36.157680108744906,62.029904848210236,1.8124150430448571,63.842319891255094
19,19197,1996,110,4136,6242,31.976930471002884,66.26081384171741,1.762255687279718,68.02306952899711
20,20001,1559,128,4155,5842,26.686066415611094,71.12290311537144,2.1910304690174596,73.3139335843889
20,20003,765,81,2874,3720,20.56451612903226,77.25806451612904,2.1774193548387095,79.43548387096774
20,20005,2314,172,4826,7312,31.64660831509847,66.00109409190372,2.352297592997812,68.35339168490154
20,20007,284,37,1992,2313,12.278426286208386,86.12191958495461,1.599654128837008,87.72157371379161
20,20009,2302,179,8480,10961,21.001733418483713,77.36520390475322,1.633062676763069,78.99826658151629
20,20011,1505,135,4910,6550,22.977099236641223,74.9618320610687,2.0610687022900764,77.02290076335878
20,20013,1088,102,3206,4396,24.749772520473158,72.92993630573248,2.3202911737943586,75.25022747952684
20,20015,9003,693,22250,31946,28.181932010267325,69.64878232016528,2.1692856695673948,71.81806798973267
20,20017,341,23,1114,1478,23.07171853856563,75.37212449255752,1.5561569688768606,76.92828146143437
20,20019,212,25,1397,1634,12.974296205630356,85.49571603427172,1.5299877600979193,87.02570379436965
20,20021,2163,160,6622,8945,24.181106763555057,74.03018446059251,1.7887087758524316,75.81889323644495
20,20023,220,22,1158,1400,15.714285714285714,82.71428571428572,1.5714285714285716,84.28571428571429
20,20025,143,20,885,1048,13.64503816793893,84.44656488549617,1.9083969465648856,86.35496183206106
20,20027,883,122,3129,4134,21.35945815191098,75.68940493468796,2.951136913401064,78.64054184808901
20,20029,893,99,3182,4174,21.394345951126017,76.23382846190704,2.371825586966938,78.60565404887399
20,20031,928,113,3407,4448,20.863309352517987,76.59622302158273,2.540467625899281,79.13669064748201
20,20033,126,33,745,904,13.938053097345133,82.41150442477876,3.650442477876106,86.06194690265487
20,20035,4171,298,9442,13911,29.983466321615985,67.87434404428151,2.142189634102509,70.01653367838401
20,20037,5971,402,9752,16125,37.029457364341084,60.477519379844956,2.4930232558139536,62.970542635658916
20,20039,208,18,1232,1458,14.266117969821673,84.49931412894375,1.2345679012345678,85.73388203017832
20,20041,2040,161,7045,9246,22.063595068137573,76.19511139952412,1.7412935323383085,77.93640493186243
20,20043,678,47,2949,3674,18.454001088731626,80.26673924877518,1.2792596624931956,81.54599891126837
20,20045,39436,1367,16737,57540,68.53667014250956,29.08759124087591,2.375738616614529,31.463329857490436
20,20047,267,19,1127,1413,18.895966029723994,79.7593772116065,1.3446567586694975,81.104033970276
20,20049,191,26,1130,1347,14.179658500371195,83.89012620638456,1.9302152932442462,85.82034149962881
20,20051,3633,299,9569,13501,26.909117843122733,70.87623139026739,2.2146507666098807,73.09088215687727
20,20053,646,54,2106,2806,23.022095509622236,75.05345687811833,1.924447612259444,76.97790449037777
20,20055,4155,232,7079,11466,36.23757195185767,61.73905459619745,2.0233734519448805,63.76242804814233
20,20057,2926,161,5763,8850,33.06214689265537,65.11864406779661,1.8192090395480225,66.93785310734464
20,20059,3623,298,8326,12247,29.582754960398468,67.98399608067281,2.433248958928717,70.41724503960154
20,20061,3825,293,5193,9311,41.08044248738052,55.772741918161316,3.1468155944581673,58.91955751261948
20,20063,163,14,1256,1433,11.37473831123517,87.64829030006979,0.9769713886950453,88.62526168876482
20,20065,222,28,1052,1302,17.050691244239633,80.79877112135176,2.1505376344086025,82.94930875576037
20,20067,497,45,1910,2452,20.26916802610114,77.89559543230015,1.8352365415986949,79.73083197389886
20,20069,337,32,1871,2240,15.044642857142856,83.52678571428571,1.4285714285714286,84.95535714285714
20,20071,77,15,537,629,12.241653418124006,85.37360890302067,2.384737678855326,87.758346581876
20,20073,562,64,2404,3030,18.54785478547855,79.33993399339934,2.112211221122112,81.45214521452145
20,20075,134,19,684,837,16.009557945041816,81.72043010752688,2.2700119474313025,83.99044205495818
20,20077,453,45,2128,2626,17.25057121096725,81.03579588728104,1.7136329017517136,82.74942878903275
20,20079,6652,367,10015,17034,39.051309146413054,58.794176353176,2.154514500410943,60.948690853586946
20,20081,261,19,1103,1383,18.872017353579178,79.75415762834417,1.373825018076645,81.12798264642082
20,20083,151,16,866,1033,14.617618586640852,83.83349467570184,1.5488867376573088,85.38238141335916
20,20085,1852,181,4435,6468,28.633271490414348,68.56833642547929,2.7983920841063696,71.36672850958566
20,20087,3106,282,6193,9581,32.418327940716004,64.63834672789896,2.943325331385033,67.58167205928399
20,20089,211,28,1369,1608,13.121890547263682,85.136815920398,1.7412935323383085,86.87810945273631
20,20091,177925,7072,151280,336277,52.910249585906854,44.98672225575939,2.1030281583337547,47.089750414093146
20,20093,255,24,1134,1413,18.046709129511676,80.2547770700637,1.6985138004246285,81.95329087048833
20,20095,745,82,3102,3929,18.961567828964114,78.95138712140493,2.0870450496309494,81.03843217103588
20,20097,153,29,957,1139,13.432835820895523,84.02107111501317,2.546093064091308,86.56716417910448
20,20099,2607,168,5639,8414,30.98407416211077,67.01925362491087,1.9966722129783694,69.01592583788923
20,20101,114,17,757,888,12.837837837837837,85.24774774774775,1.9144144144144142,87.16216216216216
20,20103,13753,984,21378,36115,38.081129724491205,59.194240620240905,2.7246296552678944,61.918870275508795
20,20105,266,31,1273,1570,16.94267515923567,81.08280254777071,1.9745222929936306,83.05732484076432
20,20107,863,100,3940,4903,17.6014684886804,80.35896389965328,2.039567611666327,82.3985315113196
20,20109,185,21,1231,1437,12.874043145441894,85.66457898399443,1.4613778705636742,87.12595685455811
20,20111,5878,363,7381,13622,43.150785494053736,54.18440757598003,2.664806929966231,56.849214505946264
20,20113,3977,329,9562,13868,28.677531006633977,68.95010095183154,2.372368041534468,71.32246899336602
20,20115,1463,129,4377,5969,24.509968168872508,73.32886580666779,2.161166024459708,75.4900318311275
20,20117,1239,122,3662,5023,24.66653394385825,72.90463866215408,2.428827393987657,75.33346605614175
20,20119,261,38,1508,1807,14.443829551743221,83.45323741007195,2.102933038184837,85.55617044825678
20,20121,5133,375,12116,17624,29.125056740807985,68.74716295960054,2.1277802995914663,70.87494325919201
20,20123,547,38,2454,3039,17.999341888779206,80.75024679170781,1.2504113195129978,82.00065811122079
20,20125,3147,262,9768,13177,23.88252257721788,74.12916445321393,1.988312969568187,76.11747742278212
20,20127,721,43,2085,2849,25.307125307125304,73.18357318357317,1.5093015093015094,74.6928746928747
20,20129,147,12,1004,1163,12.639724849527084,86.32846087704213,1.0318142734307825,87.36027515047292
20,20131,920,93,4612,5625,16.355555555555558,81.99111111111111,1.6533333333333333,83.64444444444445
20,20133,1727,107,4795,6629,26.052194901191733,72.3336853220697,1.614119776738573,73.94780509880826
20,20135,147,25,1315,1487,9.88567585743107,88.43308675184936,1.6812373907195695,90.11432414256893
20,20137,361,52,1977,2390,15.104602510460252,82.71966527196652,2.1757322175732217,84.89539748953975
20,20139,2099,203,5591,7893,26.593183833776763,70.83491701507666,2.5718991511465856,73.40681616622324
20,20141,275,34,1590,1899,14.481305950500264,83.72827804107425,1.790416008425487,85.51869404949974
20,20143,504,74,2581,3159,15.954415954415953,81.70307059195949,2.342513453624565,84.04558404558405
20,20145,635,49,2028,2712,23.414454277286136,74.77876106194691,1.8067846607669618,76.58554572271386
20,20147,373,50,2855,3278,11.378889566809029,87.09579011592434,1.5253203172666259,88.62111043319098
20,20149,3257,311,9247,12815,25.41552867733125,72.15762777994537,2.426843542723371,74.58447132266875
20,20151,924,96,3087,4107,22.4981738495252,75.16435354273192,2.3374726077428782,77.5018261504748
20,20153,214,29,1253,1496,14.304812834224597,83.7566844919786,1.9385026737967916,85.69518716577541
20,20155,8602,695,17948,27245,31.572765645072494,65.87630757937237,2.5509267755551477,68.4272343549275
20,20157,420,51,2172,2643,15.891032917139613,82.17934165720771,1.9296254256526675,84.10896708286039
20,20159,953,90,3187,4230,22.52955082742317,75.34278959810875,2.127659574468085,77.47044917257683
20,20161,11940,741,11174,23855,50.05239991616014,46.84133305386711,3.106267029972752,49.94760008383986
20,20163,332,35,2294,2661,12.47651258925216,86.20819240886884,1.3152950018789928,87.52348741074783
20,20165,291,32,1425,1748,16.647597254004577,81.52173913043478,1.8306636155606408,83.35240274599542
20,20167,591,73,2765,3429,17.235345581802274,80.63575386410032,2.1289005540974046,82.76465441819772
20,20169,8022,576,15313,23911,33.549412404332735,64.0416544686546,2.408933127012672,66.45058759566726
20,20171,290,41,1991,2322,12.489233419465979,85.74504737295435,1.7657192075796728,87.51076658053402
20,20173,90820,5079,117653,213552,42.52828350940286,55.0933730426313,2.378343447965835,57.47171649059714
20,20175,1736,78,3285,5099,34.045891351245345,64.42439694057657,1.529711708178074,65.95410864875466
20,20177,42032,2139,39890,84061,50.00178441845803,47.453634860399,2.5445807211429794,49.99821558154197
20,20179,144,16,1237,1397,10.307802433786687,88.54688618468145,1.1453113815318539,89.69219756621331
20,20181,386,65,2222,2673,14.44070332959222,83.1275720164609,2.431724653946876,85.55929667040778
20,20183,328,30,1734,2092,15.678776290630974,82.88718929254301,1.4340344168260037,84.32122370936902
20,20185,355,31,1631,2017,17.60039662865642,80.86266732771443,1.5369360436291521,82.39960337134357
20,20187,147,13,607,767,19.165580182529336,79.13950456323337,1.694915254237288,80.83441981747066
20,20189,233,33,1731,1997,11.667501251877816,86.68002003004507,1.6524787180771157,88.33249874812219
20,20191,2551,230,7998,10779,23.666388347713145,74.19983300862789,2.1337786436589665,76.33361165228686
20,20193,622,66,3106,3794,16.39430680021086,81.86610437532946,1.7395888244596729,83.60569319978914
20,20195,238,24,1341,1603,14.847161572052403,83.65564566437928,1.4971927635683093,85.1528384279476
20,20197,956,92,2813,3861,24.76042476042476,72.85677285677285,2.3828023828023825,75.23957523957525
20,20199,44,11,762,817,5.385556915544676,93.26805385556915,1.346389228886169,94.61444308445533
20,20201,467,44,2332,2843,16.42631023566655,82.02602884277172,1.5476609215617305,83.57368976433345
20,20203,147,11,803,961,15.29656607700312,83.55879292403746,1.1446409989594173,84.70343392299688
20,20205,711,77,3111,3899,18.23544498589382,79.78968966401642,1.9748653500897666,81.76455501410618
20,20207,283,23,1189,1495,18.929765886287626,79.53177257525084,1.5384615384615385,81.07023411371237
20,20209,35566,1029,18512,55107,64.53989511314352,33.592828497287094,1.8672763895693834,35.460104886856485
21,21001,1391,100,7275,8766,15.868126853753136,82.99110198494182,1.1407711613050422,84.13187314624686
21,21003,1642,135,7586,9363,17.53711417280786,81.02104026487237,1.4418455623197692,82.46288582719214
21,21005,3339,271,9651,13261,25.179096599049842,72.7773169444235,2.0435864565266573,74.82090340095016
21,21007,825,44,3356,4225,19.526627218934912,79.4319526627219,1.0414201183431953,80.47337278106508
21,21009,5115,318,14646,20079,25.47437621395488,72.94187957567608,1.5837442103690424,74.52562378604512
21,21011,1573,68,3986,5627,27.954505064865824,70.83703572063267,1.2084592145015105,72.04549493513417
21,21013,1789,115,8140,10044,17.81162883313421,81.04340900039824,1.1449621664675427,82.18837116686579
21,21015,20897,1245,44811,66953,31.211446835840068,66.92903977416994,1.859513389989993,68.78855316415994
21,21017,3296,157,6190,9643,34.18023436689827,64.19164160530954,1.628124027792181,65.81976563310172
21,21019,7083,363,14295,21741,32.57899820615427,65.75134538429695,1.669656409548779,67.42100179384573
21,21021,5298,297,8872,14467,36.62127600746526,61.32577590378102,2.0529480887537153,63.37872399253474
21,21023,799,48,3397,4244,18.826578699340246,80.04241281809612,1.1310084825636193,81.17342130065975
21,21025,1301,101,4265,5667,22.957473089818244,75.26027880712898,1.7822481030527617,77.04252691018175
21,21027,2350,146,7701,10197,23.04599391978033,75.5222124154163,1.4317936648033736,76.95400608021967
21,21029,10551,705,30708,41964,25.142979696883046,73.17700886474121,1.6800114383757507,74.85702030311695
21,21031,1078,87,4960,6125,17.599999999999998,80.9795918367347,1.420408163265306,82.4
21,21033,1432,99,4905,6436,22.249844623990057,76.2119328775637,1.5382224984462398,77.75015537600994
21,21035,5794,298,11351,17443,33.2167631714728,65.07481511207935,1.7084217164478586,66.78323682852721
21,21037,19373,978,28482,48833,39.671943153195585,58.32531280076997,2.002744046034444,60.328056846804415
21,21039,463,16,2159,2638,17.55117513267627,81.84230477634571,0.6065200909780136,82.44882486732374
21,21041,1116,65,2954,4135,26.989117291414754,71.43893591293833,1.5719467956469164,73.01088270858524
21,21043,2642,168,8775,11585,22.805351747949935,75.74449719464825,1.4501510574018126,77.19464825205006
21,21045,918,83,6179,7180,12.785515320334262,86.05849582172702,1.1559888579387188,87.21448467966573
21,21047,8296,487,15080,23863,34.7651175459917,63.19406612747769,2.0408163265306123,65.2348824540083
21,21049,6004,313,11811,18128,33.12003530450132,65.15335392762577,1.7266107678729037,66.87996469549867
21,21051,831,82,6677,7590,10.948616600790514,87.97101449275362,1.080368906455863,89.05138339920948
21,21053,603,49,4280,4932,12.226277372262775,86.78021086780211,0.9935117599351176,87.77372262773723
21,21055,731,60,3451,4242,17.23243752946723,81.35313531353135,1.4144271570014144,82.76756247053277
21,21057,508,32,2769,3309,15.35207011181626,83.68087035358114,0.967059534602599,84.64792988818374
21,21059,17283,934,31023,49240,35.099512591389114,63.00365556458164,1.8968318440292447,64.90048740861089
21,21061,1227,76,4828,6131,20.013048442342196,78.74734953514924,1.2396020225085629,79.9869515576578
21,21063,712,37,2246,2995,23.772954924874792,74.99165275459099,1.2353923205342237,76.2270450751252
21,21065,1355,83,5100,6538,20.724992352401344,78.0055062710309,1.2695013765677576,79.27500764759866
21,21067,90566,3253,58845,152664,59.32374364617723,38.54543310800189,2.1308232458208876,40.67625635382277
21,21069,1474,58,5534,7066,20.860458533823945,78.31870931219926,0.8208321539767903,79.13954146617606
21,21071,3855,315,12211,16381,23.533361821622613,74.54367865209694,1.9229595262804469,76.4666381783774
21,21073,12650,509,12900,26059,48.54368932038835,49.50305076940788,1.9532599102037684,51.45631067961165
21,21075,791,25,1605,2421,32.67244940107394,66.29491945477075,1.0326311441553075,67.32755059892605
21,21077,822,72,2955,3849,21.356196414653155,76.77318784099766,1.8706157443491818,78.64380358534684
21,21079,1830,119,6754,8703,21.027231988969323,77.60542341721246,1.3673445938182236,78.97276801103068
21,21081,2205,176,8725,11106,19.854132901134523,78.56113812353682,1.584728975328651,80.14586709886548
21,21083,3559,253,13206,17018,20.913150781525445,77.60018803619697,1.4866611822775884,79.08684921847455
21,21085,2400,130,9453,11983,20.02837352916632,78.88675623800384,1.0848702328298423,79.97162647083368
21,21087,920,54,4838,5812,15.82931865106676,83.24156916724019,0.9291121816930488,84.17068134893324
21,21089,4873,239,13064,18176,26.810079225352112,71.875,1.3149207746478873,73.18992077464789
21,21091,1351,91,3145,4587,29.45280139524744,68.56333115325921,1.9838674514933505,70.54719860475257
21,21093,18101,1008,29832,48941,36.98534970678981,60.95502748207024,2.0596228111399437,63.01465029321019
21,21095,1494,110,9367,10971,13.61771944216571,85.37963722541245,1.0026433324218396,86.38228055783429
21,21097,2400,119,6334,8853,27.10945442222975,71.54636846266801,1.3441771151022253,72.89054557777025
21,21099,1908,116,6345,8369,22.798422750627314,75.8155096188314,1.3860676305412833,77.20157724937269
21,21101,7639,319,12730,20688,36.92478731631864,61.533255993812844,1.5419566898685229,63.07521268368136
21,21103,2142,122,5843,8107,26.421610953496977,72.07351671395091,1.5048723325521156,73.57838904650302
21,21105,458,27,1714,2199,20.827648931332423,77.94452023647112,1.227830832196453,79.17235106866758
21,21107,5439,313,15757,21509,25.287089125482353,73.2577060765261,1.4552047979915383,74.71291087451765
21,21109,605,61,5450,6116,9.892086330935252,89.110529758011765,0.9973839110529757,90.10791366906474
21,21111,228288,7186,150619,386093,59.12772311334316,39.0110672817171,1.8612096049397424,40.87227688665684
21,21113,8567,588,17096,26251,32.63494724010514,65.12513808997753,2.2399146699173365,67.36505275989487
21,21115,1607,140,8446,10193,15.76572157362896,82.86078681448052,1.373491611890513,84.23427842637103
21,21117,32265,1796,48123,82184,39.25946656283462,58.555193224958636,2.1853402122067553,60.74053343716538
21,21119,1412,60,4779,6251,22.588385858262676,76.45176771716525,0.9598464245720685,77.41161414173732
21,21121,2111,158,11010,13279,15.89728142179381,82.91286994502597,1.1898486331802094,84.1027185782062
21,21123,1504,112,5685,7301,20.599917819476783,77.86604574715793,1.5340364333652923,79.40008218052321
21,21125,4474,389,23234,28097,15.923408193045521,82.69210235968252,1.3844894472719507,84.07659180695448
21,21127,1238,84,5633,6955,17.800143781452192,80.9920920201294,1.207764198418404,82.19985621854781
21,21129,459,41,2159,2659,17.262128619781873,81.19593832267769,1.5419330575404286,82.73787138021812
21,21131,446,50,4318,4814,9.264644786040714,89.6967179061072,1.038637307852098,90.73535521395928
21,21133,1799,110,7226,9135,19.693486590038315,79.10235358511221,1.20415982484948,80.30651340996168
21,21135,823,74,4986,5883,13.989461159272478,84.7526772055074,1.257861635220126,86.01053884072752
21,21137,2254,170,8489,10913,20.654265554842848,77.78795931457894,1.5577751305782095,79.34573444515715
21,21139,939,54,4010,5003,18.768738756745954,80.15190885468719,1.0793523885668599,81.23126124325404
21,21141,3094,185,9067,12346,25.060748420541067,73.44079053944597,1.4984610400129597,74.93925157945893
21,21143,1092,36,3100,4228,25.82781456953642,73.32071901608326,0.8514664143803218,74.17218543046357
21,21145,11190,511,21820,33521,33.38205900778616,65.09352346290385,1.5244175293099849,66.61794099221385
21,21147,725,46,5664,6435,11.266511266511268,88.01864801864802,0.7148407148407149,88.73348873348873
21,21149,1074,75,3633,4782,22.45922208281054,75.9723964868256,1.5683814303638646,77.54077791718946
21,21151,15580,970,27353,43903,35.487324328633576,62.30325945835137,2.209416213015056,64.51267567136642
21,21153,1213,59,4174,5446,22.273228057289753,76.64340800587587,1.083363936834374,77.72677194271024
21,21155,2722,93,6113,8928,30.48835125448029,68.46998207885304,1.0416666666666665,69.51164874551971
21,21157,4071,233,13297,17601,23.129367649565367,75.5468439293222,1.3237884211124369,76.87063235043463
21,21159,403,31,3496,3930,10.254452926208652,88.95674300254453,0.7888040712468193,89.74554707379134
21,21161,2362,119,5477,7958,29.680824327720533,68.82382508167882,1.4953505906006535,70.31917567227947
21,21163,3632,294,10184,14110,25.740609496810773,72.17576187101346,2.083628632175762,74.25939050318922
21,21165,750,41,2311,3102,24.177949709864606,74.5003223726628,1.3217279174725984,75.8220502901354
21,21167,3033,196,8506,11735,25.84576054537708,72.48402215594376,1.670217298679165,74.15423945462292
21,21169,973,84,3957,5014,19.405664140406863,78.91902672516953,1.6753091344236137,80.59433585959314
21,21171,657,45,4628,5330,12.326454033771107,86.82926829268293,0.8442776735459663,87.67354596622889
21,21173,3630,214,8993,12837,28.277634961439592,70.0553088727896,1.6670561657708187,71.72236503856041
21,21175,1172,66,4297,5535,21.1743450767841,77.63324299909665,1.1924119241192412,78.8256549232159
21,21177,3544,189,10496,14229,24.906880314849957,73.76484644036826,1.3282732447817838,75.09311968515004
21,21179,7188,354,15703,23245,30.922779092277906,67.55431275543128,1.5229081522908152,69.0772209077221
21,21181,954,35,2407,3396,28.091872791519435,70.87750294464075,1.0306242638398115,71.90812720848056
21,21183,2404,141,8582,11127,21.605104700278602,77.12770737844882,1.2671879212725803,78.3948952997214
21,21185,14504,781,22651,37936,38.23281315900464,59.70845634753269,2.058730493462674,61.76718684099536
21,21187,1098,66,4292,5456,20.124633431085044,78.66568914956011,1.2096774193548387,79.87536656891496
21,21189,216,9,1670,1895,11.398416886543536,88.12664907651715,0.47493403693931396,88.60158311345646
21,21191,1322,88,5515,6925,19.090252707581225,79.63898916967509,1.2707581227436824,80.90974729241877
21,21193,2350,138,8118,10606,22.157269470111256,76.54158023760135,1.3011502922873845,77.84273052988874
21,21195,4862,227,20279,25368,19.165878271838537,79.939293598234,0.8948281299274676,80.83412172816146
21,21197,1367,97,4041,5505,24.83197093551317,73.40599455040872,1.7620345140781108,75.16802906448683
21,21199,5664,432,25441,31537,17.959856676285,80.67032374671021,1.3698195770047878,82.040143323715
21,21201,253,9,884,1146,22.076788830715532,77.13787085514834,0.7853403141361256,77.92321116928447
21,21203,1134,72,6577,7783,14.570217139920338,84.50468970833869,0.9250931517409738,85.42978286007965
21,21205,3880,184,5994,10058,38.57625770530921,59.594352754026644,1.8293895406641478,61.42374229469079
21,21207,1329,104,7506,8939,14.867434836111421,83.9691240630943,1.1634411007942724,85.13256516388859
21,21209,10564,622,17764,28950,36.490500863557855,61.36096718480138,2.14853195164076,63.509499136442145
21,21211,8076,412,15054,23542,34.304647013847585,63.94528927024042,1.750063715911987,65.69535298615241
21,21213,2681,163,5888,8732,30.70316078790655,67.43014200641319,1.8666972056802567,69.29683921209345
21,21215,2530,162,8737,11429,22.13666987487969,76.44588327937703,1.4174468457432845,77.86333012512031
21,21217,2961,173,9376,12510,23.66906474820144,74.94804156674661,1.3828936850519584,76.33093525179856
21,21219,1202,89,4060,5351,22.463091011025977,75.87366847318259,1.663240515791441,77.53690898897402
21,21221,1791,97,5487,7375,24.284745762711864,74.4,1.3152542372881355,75.71525423728814
21,21223,1012,80,3227,4319,23.4313498495022,74.7163695299838,1.8522806205140079,76.5686501504978
21,21225,1529,82,4965,6576,23.251216545012166,75.50182481751825,1.2469586374695865,76.74878345498783
21,21227,22477,1084,31790,55351,40.60811909450597,57.43347003667504,1.9584108688189914,59.39188090549403
21,21229,1644,97,4482,6223,26.418126305640367,72.02313996464727,1.5587337297123574,73.58187369435963
21,21231,1700,110,7430,9240,18.398268398268396,80.41125541125541,1.1904761904761905,81.6017316017316
21,21233,1412,73,4506,5991,23.56868636287765,75.21281922884326,1.2184944082790854,76.43131363712234
21,21235,2552,228,12567,15347,16.628657066527662,81.88571056232489,1.4856323711474555,83.37134293347233
21,21237,837,47,2097,2981,28.077826232807784,70.34552163703455,1.576652130157665,71.92217376719222
21,21239,6530,319,8362,15211,42.92945894418513,54.97337453158898,2.097166524225889,57.07054105581487
22,22001,5443,386,22596,28425,19.148636763412487,79.4934036939314,1.3579595426561126,80.85136323658752
22,22003,2108,128,7574,9810,21.488277268093782,77.20693170234455,1.3047910295616718,78.51172273190622
22,22005,20399,1239,40687,62325,32.73004412354592,65.28198957079823,1.9879663056558365,67.26995587645408
22,22007,3833,131,7271,11235,34.116599910992434,64.71740097908322,1.1659991099243436,65.88340008900757
22,22009,4979,285,12028,17292,28.793661808928984,69.55817719176498,1.6481609993060375,71.20633819107101
22,22011,2542,240,13575,16357,15.54074708076053,82.99199119642967,1.4672617228098062,84.45925291923947
22,22013,3067,92,3891,7050,43.50354609929078,55.191489361702125,1.3049645390070923,56.49645390070922
22,22015,15662,919,38074,54655,28.656115634434176,69.66242795718598,1.6814564083798371,71.34388436556583
22,22017,55110,1781,48021,104912,52.52973921000458,45.772647552234254,1.6976132377611715,47.47026078999542
22,22019,25982,1615,55066,82663,31.43123283694035,66.61505147405732,1.9537156890023346,68.56876716305965
22,22021,745,41,3976,4762,15.644687106257873,83.49433011339772,0.8609827803443931,84.35531289374212
22,22023,324,44,3671,4039,8.021787571180985,90.88883386976974,1.0893785590492695,91.97821242881902
22,22025,1269,48,3541,4858,26.121860848085632,72.89007822149033,0.9880609304240429,73.87813915191437
22,22027,2731,79,3770,6580,41.504559270516715,57.29483282674772,1.2006079027355623,58.495440729483285
22,22029,3177,101,5550,8828,35.98776619845945,62.86814680561849,1.1440869959220663,64.01223380154056
22,22031,5457,167,9112,14736,37.03175895765472,61.83496199782845,1.1332790445168295,62.96824104234528
22,22033,115577,4185,88420,208182,55.51728775782728,42.4724519891249,2.010260253047814,44.48271224217272
22,22035,1900,56,1080,3036,62.582345191040844,35.573122529644266,1.844532279314888,37.417654808959156
22,22037,4280,165,6064,10509,40.7269959082691,57.702921305547626,1.5700827861832714,59.2730040917309
22,22039,4158,201,11053,15412,26.978977420192056,71.71684401764858,1.3041785621593562,73.02102257980795
22,22041,2658,92,6970,9720,27.34567901234568,71.70781893004116,0.9465020576131686,72.65432098765432
22,22043,1157,118,8117,9392,12.318994889267461,86.42461669505963,1.256388415672913,87.68100511073254
22,22045,11027,435,21251,32713,33.708311680371715,64.9619417357014,1.3297465839268794,66.29168831962829
22,22047,8514,312,7893,16719,50.92409833123991,47.209761349363,1.866140319397093,49.07590166876009
22,22049,2143,95,5394,7632,28.079140461215935,70.67610062893081,1.2447589098532494,71.92085953878407
22,22051,84477,3307,105949,193733,43.60485823272236,54.68815328312677,1.7069884841508676,56.39514176727764
22,22053,3208,210,11423,14841,21.615794083956608,76.96920692675697,1.4149989892864363,78.38420591604338
22,22055,39685,2317,72519,114521,34.6530330681709,63.32375721483396,2.023209716995136,65.3469669318291
22,22057,8672,692,36024,45388,19.1063717282101,79.36899621045211,1.5246320613377984,80.89362827178991
22,22059,638,61,6378,7077,9.015119400876078,90.12293344637558,0.8619471527483398,90.98488059912393
22,22061,7559,405,11311,19275,39.2166018158236,58.682230869001295,2.1011673151750974,60.7833981841764
22,22063,9249,1104,54877,65230,14.17905871531504,84.12846849609076,1.6924727885942052,85.82094128468496
22,22065,2654,86,1930,4670,56.83083511777301,41.32762312633833,1.841541755888651,43.16916488222699
22,22067,4946,118,6510,11574,42.733713495766374,56.24675997926387,1.0195265249697598,57.266286504233626
22,22069,6896,300,9358,16554,41.657605412589106,56.53014377189803,1.812250815512867,58.342394587410894
22,22071,147854,3301,26664,177819,83.14859491955303,14.995023029035142,1.8563820514118288,16.851405080446966
22,22073,25913,998,42255,69166,37.464939421102855,61.09215510510945,1.4429054737876992,62.535060578897145
22,22075,3414,188,7412,11014,30.99691301979299,67.29616851280188,1.7069184674051208,69.003086980207
22,22077,4683,185,7503,12371,37.854660092151,60.64990704065961,1.4954328671893946,62.145339907849
22,22079,19475,1043,38347,58865,33.08417565616241,65.14397349868342,1.7718508451541664,66.91582434383758
22,22081,1644,75,2413,4132,39.787028073572124,58.39787028073572,1.8151016456921587,60.212971926427876
22,22083,3225,108,6607,9940,32.44466800804829,66.46881287726359,1.0865191146881288,67.5553319919517
22,22085,1731,89,8776,10596,16.336353340883353,82.82370705926765,0.8399395998489996,83.66364665911665
22,22087,6151,320,11179,17650,34.84985835694051,63.3371104815864,1.8130311614730876,65.1501416430595
22,22089,9800,484,18233,28517,34.365466213136024,63.93730055756216,1.69723322930182,65.63453378686398
22,22091,3346,98,2714,6158,54.335823319259504,44.07275089314713,1.5914257875933744,45.664176680740496
22,22093,6510,126,5954,12590,51.7077045274027,47.291501191421766,1.0007942811755361,48.2922954725973
22,22095,13582,312,7538,21432,63.372527062336694,35.17170586039567,1.4557670772676372,36.627472937663306
22,22097,17372,611,23171,41154,42.21217864606114,56.30315400690091,1.484667347037955,57.78782135393886
22,22099,8439,396,18203,27038,31.211628078999926,67.32376655078039,1.4646053702196908,68.78837192100008
22,22101,8055,320,14811,23186,34.74079185715518,63.87906495298887,1.3801431898559475,65.25920814284481
22,22103,37746,2698,99666,140110,26.94026122332453,71.13410891442437,1.9256298622510886,73.05973877667547
22,22105,18887,968,37806,57661,32.75524184457432,65.56598047206951,1.6787776833561678,67.24475815542567
22,22107,1329,28,1197,2554,52.03602192638998,46.867658574784656,1.096319498825372,47.96397807361002
22,22109,11198,703,34339,46240,24.21712802768166,74.26254325259517,1.5203287197231834,75.78287197231833
22,22111,2654,140,8407,11201,23.694313007767164,75.05579858941167,1.2498884028211765,76.30568699223284
22,22113,5009,385,21930,27324,18.331869418825942,80.25911286780853,1.4090177133655395,81.66813058117405
22,22115,2898,263,14107,17268,16.782487838776927,81.69446374797313,1.523048413249942,83.21751216122307
22,22117,5970,236,13307,19513,30.594987956746785,68.19556193307025,1.209450110182955,69.40501204325321
22,22119,6172,214,11830,18216,33.88230127360562,64.94290733421168,1.1747913921826967,66.11769872639438
22,22121,6200,213,7684,14097,43.980988862878625,54.508051358445066,1.510959778676314,56.019011137121375
22,22123,710,25,4317,5052,14.05384006334125,85.45130641330167,0.49485352335708627,85.94615993665874
22,22125,2298,107,3863,6268,36.66241225271219,61.63050414805361,1.7070835992342055,63.33758774728781
22,22127,1543,63,4619,6225,24.78714859437751,74.20080321285141,1.0120481927710843,75.21285140562249
23,23001,27568,1943,29259,58770,46.90828654075209,49.78560490045942,3.3061085587884973,53.09171345924791
23,23003,13318,746,19622,33686,39.53571216529122,58.24971798373212,2.214569850976667,60.46428783470878
23,23005,128563,5891,59491,193945,66.28838072649462,30.674160200056715,3.0374590734486584,33.71161927350538
23,23007,7061,586,7324,14971,47.164518068265316,48.92124774564157,3.914234186093114,52.835481931734684
23,23009,18412,961,13662,33035,55.73482669895565,41.35613742999848,2.9090358710458606,44.26517330104435
23,23011,34741,2345,34606,71692,48.45868437203593,48.27037884282765,3.270936785136417,51.54131562796407
23,23013,14798,635,9870,25303,58.48318381219618,39.007232343990836,2.5095838438129863,41.51681618780382
23,23015,11807,612,9723,22142,53.323999638695696,43.91202240086713,2.7639779604371784,46.676000361304304
23,23017,14027,997,16860,31884,43.99385271609585,52.87918705306737,3.126960230836783,56.00614728390415
23,23019,35327,2703,40132,78162,45.19715462756838,51.344643176991376,3.4582021954402395,54.80284537243162
23,23021,3273,248,5703,9224,35.48352124891587,61.82784041630529,2.6886383347788376,64.51647875108412
23,23023,13531,756,9755,24042,56.280675484568675,40.57482738540887,3.1444971300224602,43.719324515431325
23,23025,8971,643,13915,23529,38.127417229801516,59.13978494623656,2.7327978239619193,61.872582770198484
23,23027,11945,779,10824,23548,50.72617632070664,45.965687107185325,3.308136572108035,49.27382367929336
23,23029,4652,302,7104,12058,38.58019572068336,58.91524299220434,2.5045612871122906,61.41980427931664
23,23031,72363,3884,54099,130346,55.51608795053167,41.504150491768065,2.9797615577002747,44.48391204946833
24,24001,9158,467,20886,30511,30.015404280423454,68.45400019665038,1.5305955229261579,69.98459571957655
24,24003,172823,6280,127821,306924,56.30807626643729,41.645814599053836,2.046109134508869,43.69192373356271
24,24005,236859,6696,139229,382784,61.877978180906204,36.37273240260826,1.7492894164855375,38.122021819093796
24,24009,22587,899,25346,48832,46.254505242463956,51.904488859764086,1.8410058977719528,53.745494757536044
24,24011,5095,351,10283,15729,32.39239621082078,65.37605696484201,2.2315468243372116,67.60760378917922
24,24013,36456,2734,60218,99408,36.67310478029937,60.5766135522292,2.7502816674714308,63.32689521970063
24,24015,16809,1025,29439,47273,35.55729486176041,62.27444841664374,2.168256721595837,64.44270513823959
24,24017,62171,1313,25579,89063,69.80564319638908,28.72011946599598,1.4742373376149467,30.194356803610916
24,24019,6857,313,8764,15934,43.03376427764529,55.00188276641145,1.964352955943266,56.96623572235471
24,24021,76554,3154,63101,142809,53.60586517656451,44.18559054401333,2.2085442794221652,46.39413482343549
24,24023,3281,296,12002,15579,21.060401822966814,77.03960459593043,1.8999935811027664,78.93959817703319
24,24025,63095,3196,80930,147221,42.85733692883488,54.97177712418745,2.1708859469776733,57.14266307116512
24,24027,129433,3501,48390,181324,71.38216672916988,26.687035362114226,1.9307979087158897,28.61783327083012
24,24029,5329,216,5195,10740,49.618249534450655,48.37057728119181,2.011173184357542,50.381750465549345
24,24031,385321,7902,94335,487558,79.03080248913975,19.34846725927992,1.6207302515803248,20.969197510860255
24,24033,370212,6382,36006,412600,89.72661173048958,8.726611730489578,1.5467765390208434,10.27338826951042
24,24035,10709,629,18741,30079,35.60291233086206,62.30592772366103,2.0911599454769108,64.39708766913793
24,24037,23138,1375,30826,55339,41.8113807622111,55.70393393447659,2.4846853033123115,58.1886192377889
24,24039,4241,137,5739,10117,41.91954136601759,56.72630226351685,1.354156370465553,58.08045863398241
24,24041,11062,392,10946,22400,49.38392857142857,48.86607142857143,1.7500000000000002,50.61607142857143
24,24043,26044,1242,40221,67507,38.57970284563083,59.58048794939784,1.8398092049713364,61.42029715436917
24,24045,22054,977,22944,45975,47.96954866775421,49.90538336052202,2.125067971723763,52.03045133224579
24,24047,12560,436,18571,31567,39.78838660626604,58.83042417714702,1.381189216586942,60.21161339373396
24,24510,205558,3519,25169,234246,87.75304594315378,10.744687209173263,1.5022668476729593,12.24695405684622
25,25001,90617,3013,54759,148389,61.0671950077162,36.90233103531933,2.0304739569644648,38.9328049922838
25,25003,50864,1548,17713,70125,72.53333333333333,25.259180035650626,2.207486631016043,27.46666666666667
25,25005,150063,5897,118085,274045,54.75852505975296,43.08963856300972,2.151836377237315,45.24147494024704
25,25007,9763,244,2588,12595,77.51488685986503,20.54783644303295,1.9372766971020245,22.48511314013497
25,25009,262332,9194,142822,414348,63.311998609864176,34.469093612132795,2.218907778003031,36.688001390135824
25,25011,29048,1183,10875,41106,70.66608281029534,26.4559918260108,2.8779253636938646,29.333917189704664
25,25013,123985,4798,85879,214662,57.758243191622185,40.00661505063775,2.235141757740075,42.241756808377815
25,25015,61555,1942,21807,85304,72.1595704773516,25.563865703835692,2.2765638188127166,27.840429522648407
25,25017,599370,19427,223374,842171,71.169631820616,26.52359200209934,2.306776177284661,28.830368179383996
25,25019,5234,151,1912,7297,71.72810744141428,26.20254899273674,2.069343565848979,28.27189255858572
25,25021,268378,9055,123839,401272,66.88181582567435,30.861610079945773,2.256574094379872,33.11818417432565
25,25023,171347,6938,120192,298477,57.40710339490145,40.26842939321958,2.3244672118789724,42.59289660509855
25,25025,252661,5750,55699,314110,80.43710801948362,17.73232307153545,1.8305689089809303,19.562891980516383
25,25027,243957,11418,169758,425133,57.38368933957139,39.930562906196414,2.685747754232205,42.61631066042861
26,26001,2142,73,4848,7063,30.327056491575817,68.63938836188589,1.0335551465382982,69.67294350842418
26,26003,2053,68,3014,5135,39.98052580331061,58.6952288218111,1.3242453748782863,60.01947419668939
26,26005,24447,1354,41381,67182,36.38921139590962,61.59536780685303,2.0154207972373555,63.61078860409038
26,26007,6000,280,10686,16966,35.364847341742305,62.98479311564306,1.650359542614641,64.6351526582577
26,26009,7289,275,9783,17347,42.01879287484868,56.39591860264023,1.5852885225110969,57.98120712515132
26,26011,2774,129,5928,8831,31.412071113124224,67.12716566640245,1.4607632204733327,68.58792888687577
26,26013,1478,46,2512,4036,36.620416253716556,62.239841427155596,1.1397423191278493,63.379583746283444
26,26015,11804,637,23473,35914,32.86740546861948,65.35891295873476,1.773681572645765,67.13259453138052
26,26017,26653,985,33347,60985,43.70418955480856,54.680659178486515,1.6151512667049273,56.29581044519144
26,26019,5480,179,6601,12260,44.69820554649266,53.841761827079935,1.4600326264274062,55.30179445350734
26,26021,37438,1422,43519,82379,45.44604814333751,52.827783779846804,1.7261680768156933,54.55395185666249
26,26023,6161,313,14067,20541,29.99367119419697,68.48254710092012,1.523781704882917,70.00632880580304
26,26025,28417,1251,35900,65568,43.33973889702294,54.75231820400195,1.90794289897511,56.66026110297706
26,26027,9122,413,16686,26221,34.78890965256855,63.63601693299263,1.5750734144388088,65.21109034743145
26,26029,6939,220,9841,17000,40.81764705882353,57.88823529411765,1.2941176470588236,59.18235294117647
26,26031,5437,245,10186,15868,34.26392740105874,64.1920846987648,1.5439879001764558,65.73607259894126
26,26033,6651,342,10682,17675,37.62942008486563,60.43564356435643,1.9349363507779347,62.37057991513437
26,26035,5200,220,10860,16280,31.941031941031937,66.70761670761671,1.3513513513513513,68.05896805896806
26,26037,21968,844,25098,47910,45.852640367355455,52.385723231058236,1.7616364015863077,54.147359632644545
26,26039,2672,102,5087,7861,33.9905864393843,64.71186871899249,1.2975448416232032,66.0094135606157
26,26041,7605,343,13206,21154,35.95064763165359,62.4279096152028,1.6214427531436135,64.0493523683464
26,26043,4744,228,9617,14589,32.5176502844609,65.91952841181711,1.5628213037219822,67.4823497155391
26,26045,31297,1357,31797,64451,48.55937068470621,49.335153837799254,2.105475477494531,51.44062931529379
26,26047,9662,379,12135,22176,43.56962481962482,54.72132034632035,1.709054834054834,56.43037518037518
26,26049,120082,3688,99199,222969,53.85591719028206,44.490041216491974,1.654041593225964,46.14408280971794
26,26051,4524,186,9893,14603,30.97993562966514,67.74635348900911,1.273710881325755,69.02006437033486
26,26053,3573,106,4600,8279,43.157386157748526,55.56226597415147,1.280347868100012,56.842613842251474
26,26055,28683,1042,30502,60227,47.62481943314461,50.64505952479785,1.7301210420575488,52.37518056685539
26,26057,6693,353,12102,19148,34.95404219761855,63.20242322958012,1.843534572801337,65.04595780238145
26,26059,5883,368,17037,23288,25.261937478529717,73.15784953624184,1.580212985228444,74.73806252147028
26,26061,7755,405,10380,18540,41.82847896440129,55.98705501618123,2.1844660194174756,58.17152103559871
26,26063,5349,225,11949,17523,30.525594932374595,68.19037835986988,1.2840267077555212,69.47440506762541
26,26065,94221,2936,47640,144797,65.07109953935509,32.90123414159133,2.0276663190535715,34.92890046064491
26,26067,10901,647,20657,32205,33.84878124514827,64.14221394193447,2.0090048129172486,66.15121875485173
26,26069,5371,255,9760,15386,34.908358247757704,63.43429091381776,1.6573508384245417,65.0916417522423
26,26071,2493,86,4216,6795,36.688741721854306,62.04562178072111,1.2656364974245768,63.311258278145694
26,26073,14072,522,14815,29409,47.849297833996395,50.37573531912,1.774966846883607,52.150702166003605
26,26075,32004,1647,47381,81032,39.495507947477535,58.47196169414553,2.0325303583769374,60.504492052522465
26,26077,83686,2867,56823,143376,58.368206673362344,39.63215600937395,1.9996373172636983,41.631793326637656
26,26079,3003,188,7436,10627,28.258210219252845,69.97271101910229,1.7690787616448669,71.74178978074715
26,26081,187915,7183,165741,360839,52.07724220497229,45.93211931082838,1.9906384841993245,47.92275779502771
26,26083,672,23,862,1557,43.15992292870906,55.362877328195246,1.477199743095697,56.84007707129094
26,26085,2288,98,3946,6332,36.133922931143395,62.31838281743525,1.5476942514213519,63.866077068856605
26,26087,16368,791,35480,52639,31.09481563099603,67.40249624802902,1.5026881209749425,68.90518436900396
26,26089,8793,222,7915,16930,51.93738924985233,46.751329001772,1.3112817483756645,48.06261075014767
26,26091,20916,993,31539,53448,39.13336326897171,59.00875617422542,1.8578805568028738,60.86663673102829
26,26093,48220,1964,76982,127166,37.918940597329474,60.53662142396553,1.5444379787049998,62.081059402670526
26,26095,842,150,2109,3101,27.152531441470494,68.01031925185424,4.837149306675266,72.8474685585295
26,26097,2632,79,4304,7015,37.519600855310046,61.35424091233072,1.12615823235923,62.480399144689954
26,26099,225561,6427,264535,496523,45.428107056470694,53.27749167712271,1.2944012664065914,54.571892943529306
26,26101,6107,226,8321,14654,41.67462808789409,56.783130885764976,1.5422410263409307,58.32537191210591
26,26103,20465,707,16288,37460,54.63160704751735,43.481046449546184,1.8873465029364656,45.36839295248265
26,26105,6802,240,10207,17249,39.434170096817205,59.174444895356245,1.3913850078265406,60.565829903182795
26,26107,7373,439,13265,21077,34.9812591924847,62.93590169378944,2.0828391137258624,65.0187408075153
26,26109,4314,188,8120,12622,34.17841863413088,64.33211852321344,1.4894628426556806,65.82158136586912
26,26111,20493,1007,27675,49175,41.67361464158617,56.27859684799187,2.047788510421962,58.32638535841383
26,26113,1967,140,6648,8755,22.467161621930327,75.93375214163335,1.599086236436322,77.53283837806967
26,26115,32975,1463,52710,87148,37.837930876210585,60.48331573874328,1.6787533850461285,62.162069123789415
26,26117,9703,568,21815,32086,30.240603378420495,67.98915414822663,1.770242473352864,69.7593966215795
26,26119,1628,64,4171,5863,27.76735459662289,71.14105406788333,1.0915913354937745,72.2326454033771
26,26121,45508,1649,44544,91701,49.6265035277696,48.575260902280235,1.7982355699501642,50.3734964722304
26,26123,7874,426,18864,27164,28.98689441908408,69.44485348255044,1.5682520983654837,71.01310558091592
26,26125,433982,11871,325916,771769,56.232110903651225,42.229734544922124,1.5381545514266575,43.767889096348775
26,26127,4944,244,8892,14080,35.11363636363637,63.15340909090909,1.7329545454545454,64.88636363636363
26,26129,3475,179,8253,11907,29.18451331149744,69.31216931216932,1.5033173763332492,70.81548668850256
26,26131,1391,61,2358,3810,36.509186351706035,61.88976377952756,1.601049868766404,63.490813648293965
26,26133,3214,198,8928,12340,26.045380875202596,72.35008103727715,1.6045380875202593,73.9546191247974
26,26135,1342,66,3466,4874,27.533853098071397,71.11202297907263,1.3541239228559705,72.4661469019286
26,26137,4743,234,9779,14756,32.142857142857146,66.27134724857684,1.585795608566007,67.85714285714286
26,26139,64705,3009,100913,168627,38.37167238935639,59.843915861635445,1.784411749008166,61.62832761064361
26,26141,2912,105,5343,8360,34.83253588516747,63.91148325358852,1.255980861244019,65.16746411483254
26,26143,5166,182,9670,15018,34.39872153415901,64.38939938740178,1.2118790784392062,65.60127846584099
26,26145,51088,1474,50785,103347,49.43346202599011,49.14027499588764,1.4262629781222482,50.56653797400989
26,26147,31363,1515,59186,92064,34.06651894334376,64.28788668752172,1.6455943691345152,65.93348105665623
26,26149,9262,592,18128,27982,33.0998499035094,64.78450432420843,2.115645772282181,66.90015009649059
26,26151,5966,286,16194,22446,26.579345985921766,72.14648489708634,1.2741691169918916,73.42065401407824
26,26153,1589,66,3090,4745,33.487881981032665,65.12118018967334,1.3909378292939936,66.51211801896733
26,26155,15371,725,23154,39250,39.16178343949044,58.991082802547766,1.8471337579617835,60.83821656050956
26,26157,8713,472,20310,29495,29.540600101712155,68.85912866587557,1.6002712324122734,70.45939989828784
26,26159,16803,669,21591,39063,43.0151294063436,55.27225251516781,1.7126180784885952,56.9848705936564
26,26161,157130,3553,56241,216924,72.43550736663532,25.926591801737015,1.6379008316276669,27.56449263336468
26,26163,597170,10660,264553,872383,68.45273234347758,30.325327293172837,1.2219403633495838,31.547267656522422
26,26165,5838,352,12102,18292,31.915591515416576,66.16006997594577,1.9243385086376557,68.08440848458342
27,27001,3607,145,6258,10010,36.03396603396604,62.51748251748251,1.4485514485514486,63.96603396603396
27,27003,100892,4696,104903,210491,47.931740549477176,49.837285204593066,2.230974245929755,52.068259450522824
27,27005,6592,374,12452,19418,33.947883407148005,64.1260685961479,1.9260479967040889,66.052116592852
27,27007,11426,517,12188,24131,47.349881894658324,50.507645766855916,2.1424723384857653,52.650118105341676
27,27009,7281,556,14382,22219,32.769251541473515,64.7283856159143,2.5023628426121785,67.23074845852648
27,27011,1052,58,1862,2972,35.39703903095558,62.6514131897712,1.9515477792732168,64.60296096904442
27,27013,18330,908,16731,35969,50.96054936195057,46.515054630376156,2.524396007673274,49.03945063804943
27,27015,4750,330,9550,14630,32.467532467532465,65.27682843472317,2.2556390977443606,67.53246753246754
27,27017,10094,480,9787,20361,49.57516821374196,48.06738372378567,2.3574480624723737,50.42483178625804
27,27019,30770,1337,34012,66119,46.5373039519654,51.440584400853005,2.022111647181597,53.4626960480346
27,27021,6342,293,11621,18256,34.739263803680984,63.65578439964943,1.6049517966695883,65.26073619631902
27,27023,2226,135,4250,6611,33.67115413704432,64.28679473604598,2.042051126909696,66.32884586295569
27,27025,11803,775,21915,34493,34.21853709448294,63.534630214826194,2.246832690690865,65.78146290551706
27,27027,16345,839,15031,32215,50.737234207667235,46.65838894924724,2.604376843085519,49.262765792332765
27,27029,1258,76,3371,4705,26.7375132837407,71.6471838469713,1.6153028692879916,73.2624867162593
27,27031,2496,86,1203,3785,65.94451783355349,31.78335535006605,2.272126816380449,34.05548216644651
27,27033,1834,98,4165,6097,30.080367393800227,68.31228473019519,1.6073478760045925,69.91963260619977
27,27035,13726,671,25676,40073,34.25248920719687,64.07306665335763,1.674444139445512,65.74751079280313
27,27037,145510,6414,109183,261107,55.72811146388263,41.81542432795751,2.4564642081598733,44.27188853611737
27,27039,4074,305,7774,12153,33.522587015551714,63.967744589813215,2.5096683946350695,66.47741298444828
27,27041,7868,453,15799,24120,32.62023217247098,65.5016583747927,1.8781094527363182,67.37976782752902
27,27043,2531,170,5191,7892,32.0704510897111,65.77546882919411,2.1540800810947793,67.9295489102889
27,27045,4551,252,7301,12104,37.59914077990747,60.31890284203569,2.081956378056841,62.40085922009253
27,27047,6889,324,9578,16791,41.0279316300399,57.04246322434637,1.9296051456137215,58.9720683699601
27,27049,11805,709,16052,28566,41.3253518168452,56.19267660855562,2.481971574599174,58.6746481831548
27,27051,1300,81,2269,3650,35.61643835616438,62.16438356164383,2.219178082191781,64.38356164383562
27,27053,532608,14585,205966,753159,70.71654192541017,27.346947988406168,1.9365100861836613,29.28345807458983
27,27055,4851,253,6334,11438,42.41126070991432,55.37681412834412,2.211925161741563,57.58873929008568
27,27057,4462,263,8202,12927,34.5169026069467,63.44859596194012,2.034501431113174,65.4830973930533
27,27059,7138,533,16491,24162,29.542256435725516,68.25180034765333,2.2059432166211406,70.45774356427448
27,27061,10787,486,15239,26512,40.68723596861798,57.47963186481593,1.8331321665660834,59.31276403138202
27,27063,1745,120,3948,5813,30.018923103388957,67.91673834508859,2.0643385515224497,69.98107689661104
27,27065,2774,172,6278,9224,30.07372072853426,68.061578490893325,1.8647007805724198,69.92627927146575
27,27067,8440,436,14437,23313,36.20297687985244,61.92682194483764,1.870201175309913,63.79702312014756
27,27069,1006,87,1546,2639,38.12050018946571,58.58279651383099,3.296703296703297,61.87949981053429
27,27071,2657,132,4131,6920,38.395953757225435,59.69653179190752,1.907514450867052,61.604046242774565
27,27073,1445,67,2527,4039,35.77618222332261,62.56499133448874,1.6588264421886605,64.2238177766774
27,27075,3646,162,3392,7200,50.638888888888886,47.11111111111111,2.25,49.361111111111114
27,27077,671,30,1704,2405,27.900207900207903,70.85239085239085,1.2474012474012475,72.0997920997921
27,27079,5671,329,10775,16775,33.806259314456035,64.23248882265275,1.961251862891207,66.19374068554396
27,27081,937,57,2120,3114,30.089916506101478,68.0796403339756,1.8304431599229287,69.91008349389853
27,27083,4630,280,7979,12889,35.92210411979207,61.90550081464815,2.1723950655597797,64.07789588020793
27,27085,6413,489,13986,20888,30.701838376101108,66.95710455764075,2.3410570662581387,69.29816162389889
27,27087,1112,48,1143,2303,48.284845853234906,49.63091619626574,2.0842379504993485,51.715154146765094
27,27089,1295,85,3721,5101,25.387178984512843,72.94648108214076,1.6663399333464026,74.61282101548716
27,27091,3304,258,7476,11038,29.932958869360395,67.7296611705019,2.337379960137706,70.06704113063961
27,27093,3867,271,9358,13496,28.652934202726733,69.33906342620035,2.0080023710729105,71.34706579727327
27,27095,4403,310,9953,14666,30.0218191735988,67.86444838401745,2.1137324423837445,69.9781808264012
27,27097,4367,337,14819,19523,22.368488449521077,75.90534241663678,1.726169133842135,77.63151155047892
27,27099,8997,377,10067,19441,46.27848361709789,51.782315724499774,1.9392006584023453,53.72151638290211
27,27101,1449,71,3363,4883,29.674380503788655,68.8715953307393,1.4540241654720458,70.32561949621135
27,27103,9622,484,9018,19124,50.313741895001044,47.155406818657184,2.5308512863417696,49.686258104998956
27,27105,2928,182,5598,8708,33.624253559944876,64.28571428571429,2.090032154340836,66.37574644005512
27,27107,1404,76,1954,3434,40.885264997087944,56.9015725101922,2.21316249271986,59.114735002912056
27,27109,49492,1902,39692,91086,54.33546318863491,43.576400324967615,2.0881364863974703,45.66453681136509
27,27111,11940,638,23794,36372,32.82744968657209,65.41845375563621,1.7540965577917078,67.1725503134279
27,27113,2568,163,4532,7263,35.35729037587774,62.39845793749139,2.244251686630869,64.64270962412226
27,27115,5416,326,10256,15998,33.85423177897237,64.10801350168771,2.0377547193399175,66.14576822102762
27,27117,1306,73,3553,4932,26.480129764801298,72.0397404703974,1.4801297648012977,73.51987023519871
27,27119,5435,289,9857,15581,34.882228355047815,63.26294846287145,1.8548231820807393,65.11777164495219
27,27121,2478,128,4413,7019,35.30417438381536,62.872204017666334,1.8236215985183075,64.695825616184635
27,27123,211362,5827,77324,294513,71.76661132106223,26.254868206157283,1.9785204727804884,28.23338867893777
27,27125,689,51,1450,2190,31.461187214611876,66.21004566210046,2.328767123287671,68.53881278538813
27,27127,2358,157,5775,8290,28.443908323281065,69.66224366706875,1.893848009650181,71.55609167671894
27,27129,2497,153,5465,8115,30.770178681454098,67.34442390634628,1.8853974121996304,69.2298213185459
27,27131,17402,743,17463,35608,48.87104021568187,49.042350033700295,2.0866097506178387,51.12895978431813
27,27133,1554,101,3580,5235,29.68481375358166,68.38586437440306,1.9293218720152816,70.31518624641834
27,27135,2188,155,6065,8408,26.02283539486204,72.1336822074215,1.8434823977164605,73.97716460513796
27,27137,67836,2809,49214,119859,56.59650088854404,41.059912063341095,2.3435870481148684,43.40349911145596
27,27139,40037,1821,45871,87729,45.63713253314183,52.28715704043133,2.0757104264268373,54.36286746685817
27,27141,18065,1200,36221,55486,32.55776231842267,65.27952997152435,2.1627077100529863,67.44223768157732
27,27143,2417,170,5864,8451,28.600165660868537,69.38823807833393,2.0115962607975386,71.39983433913146
27,27145,31883,1804,50960,84647,37.66583576500053,60.2029605302019,2.1312037047975707,62.33416423499947
27,27147,7917,503,12656,21076,37.56405390017081,60.04934522679826,2.3866008730309356,62.43594609982919
27,27149,1921,97,3044,5062,37.949427103911496,60.13433425523509,1.9162386408534176,62.050572896088504
27,27151,1784,85,3316,5185,34.4069431051109,63.95371263259402,1.639344262295082,65.5930568948891
27,27153,3286,197,9755,13238,24.82248073727149,73.68937906028101,1.4881402024474997,75.17751926272851
27,27155,662,29,1173,1864,35.51502145922747,62.92918454935622,1.555793991416309,64.48497854077253
27,27157,4696,248,8153,13097,35.85553943651218,62.25089715201955,1.8935634114682753,64.14446056348783
27,27159,2023,118,5520,7661,26.406474350606967,72.05325675499282,1.5402688944002088,73.59352564939303
27,27161,3496,269,6624,10389,33.65097699489845,63.75974588507075,2.589277120030802,66.34902300510154
27,27163,89164,3339,73764,166267,53.626997540101165,44.364786758647234,2.008215701251601,46.373002459898835
27,27165,1987,101,3103,5191,38.277788480061645,59.77653631284916,1.945675207089193,61.722211519938355
27,27167,1027,75,2333,3435,29.8981077147016,67.91848617176129,2.1834061135371177,70.1018922852984
27,27169,13333,548,13227,27108,49.184742511435736,48.793714032757855,2.021543455806404,50.815257488564264
27,27171,28427,2023,51970,82420,34.4904149478282,63.05508371754428,2.4545013346275177,65.5095850521718
27,27173,1685,106,3734,5525,30.497737556561088,67.58371040723982,1.9185520361990949,69.50226244343891
28,28001,6914,132,5222,12268,56.358004564721234,42.56602543201826,1.0759700032605153,43.641995435278766
28,28003,2782,211,12818,15811,17.59534501296566,81.07014104104738,1.334513945986971,82.40465498703435
28,28005,2620,84,4503,7207,36.35354516442348,62.48092132648814,1.1655335090883863,63.64645483557652
28,28007,3542,112,5178,8832,40.10416666666667,58.627717391304344,1.2681159420289856,59.89583333333333
28,28009,1679,43,2570,4292,39.119291705498604,59.87884436160298,1.0018639328984158,60.880708294501396
28,28011,8904,180,4671,13755,64.73282442748092,33.95856052344602,1.3086150490730644,35.26717557251908
28,28013,1902,68,4625,6595,28.840030326004552,70.12888551933283,1.031084154662623,71.15996967399545
28,28015,1729,52,3924,5705,30.306748466257673,68.78177037686241,0.9114811568799298,69.69325153374233
28,28017,3810,163,4175,8148,46.759941089837994,51.23956799214531,2.000490918016691,53.240058910162006
28,28019,1185,39,3001,4225,28.04733727810651,71.02958579881657,0.9230769230769231,71.95266272189349
28,28021,3772,78,603,4453,84.70693914215136,13.541432741971704,1.7516281158769367,15.293060857848644
28,28023,2838,92,5417,8347,34.00023960704445,64.89756798849886,1.102192404456691,65.99976039295555
28,28025,5844,181,4181,10206,57.26043503821282,40.96609837350578,1.7734665882814031,42.73956496178718
28,28027,6130,112,2400,8642,70.93265447813006,27.771349224716502,1.2959962971534367,29.06734552186994
28,28029,6470,177,6250,12897,50.16670543537257,48.4608823757463,1.3724121888811351,49.83329456462743
28,28031,3416,101,5854,9371,36.452886564934374,62.469320243303805,1.0777931917618184,63.547113435065626
28,28033,28265,1521,46462,76248,37.06982478228937,60.9353687965586,1.9948064211520302,62.93017521771063
28,28035,13755,680,17290,31725,43.35697399527187,54.499605988967694,2.1434200157604413,56.64302600472813
28,28037,1480,61,2923,4464,33.15412186379928,65.47939068100358,1.3664874551971327,66.84587813620072
28,28039,1218,133,9713,11064,11.008676789587852,87.78922631959509,1.2020968908170642,88.99132321041215
28,28041,966,56,4794,5816,16.609353507565334,82.42778541953233,0.9628610729023385,83.39064649243467
28,28043,2866,83,4889,7838,36.56545036999235,62.37560602194437,1.0589436080632815,63.43454963000765
28,28045,4504,321,16132,20957,21.491625709786707,76.97666650761083,1.5317077826024716,78.5083742902133
28,28047,27728,1315,46822,75865,36.54913332893956,61.71752455018783,1.7333421208726028,63.45086667106044
28,28049,59192,1377,21242,81811,72.3521286868514,25.96472357018005,1.6831477429685493,27.6478713131486
28,28051,5182,164,1196,6542,79.21125038214613,18.281870987465606,2.5068786303882606,20.788749617853867
28,28053,3016,55,1118,4189,71.99809023633325,26.688947242778703,1.3129625208880402,28.001909763666745
28,28055,355,13,308,676,52.51479289940828,45.562130177514796,1.9230769230769231,47.48520710059172
28,28057,1249,139,9438,10826,11.53704045815629,87.1790134860521,1.283946055791613,88.4629595418437
28,28059,17375,953,36295,54623,31.80894494992952,66.44636874576643,1.7446863043040477,68.19105505007047
28,28061,4341,99,4302,8742,49.656829100892246,49.21070693205216,1.1324639670555936,50.343170899107754
28,28063,3327,53,531,3911,85.06775760675019,13.577090258245972,1.3551521350038354,14.932242393249808
28,28065,3599,80,2534,6213,57.92692741026879,40.78544986319009,1.2876227265411235,42.07307258973121
28,28067,8517,348,21226,30091,28.3041440962414,70.53936392941411,1.1564919743444884,71.6958559037586
28,28069,2887,58,1787,4732,61.010143702451394,37.76415891800507,1.2256973795435333,38.989856297548606
28,28071,10070,462,12949,23481,42.88573740471019,55.14671436480558,1.9675482304842211,57.11426259528981
28,28073,7340,482,20704,28526,25.730912150319007,72.5794012479843,1.6896866016966976,74.269087849681
28,28075,12960,339,17967,31266,41.45077720207254,57.464977931299174,1.0842448666282862,58.54922279792746
28,28077,2260,72,4285,6617,34.15445065739761,64.75744294997733,1.0881063926250567,65.8455493426024
28,28079,3897,79,5228,9204,42.34028683181226,56.80139069969579,0.85832246849196,57.65971316818774
28,28081,9910,555,21297,31762,31.200805994584723,67.05182293306467,1.7473710723506077,68.79919400541527
28,28083,5444,111,2623,8178,66.56884323795549,32.07385668867694,1.3573000733675715,33.43115676204451
28,28085,5040,182,11596,16818,29.967891544773455,68.94993459388749,1.0821738613390415,70.03210845522655
28,28087,13087,386,13800,27273,47.98518681479852,50.59949400505995,1.415319180141532,52.01481318520148
28,28089,24440,804,31091,56335,43.38333185408716,55.18949143516464,1.4271767107482027,56.61666814591284
28,28091,3787,134,8273,12194,31.056257175660164,67.84484172543874,1.098901098901099,68.94374282433984
28,28093,8057,207,7566,15830,50.89703095388502,47.79532533164877,1.3076437144662034,49.10296904611498
28,28095,5874,228,11177,17279,33.99502286011922,64.6854563342786,1.319520805602176,66.00497713988078
28,28097,2121,40,2917,5078,41.7684127609295,57.44387554155179,0.7877116975187082,58.2315872390705
28,28099,3260,140,8320,11720,27.815699658703068,70.98976109215018,1.1945392491467577,72.18430034129693
28,28101,3075,117,6997,10189,30.17960545686525,68.67209735989793,1.148297183236824,69.82039454313475
28,28103,4040,61,1240,5341,75.641265680584155,23.216626099981276,1.1421082194345629,24.358734319415845
28,28105,10299,509,9004,19812,51.983646274984864,45.44720371492025,2.5691500100948916,48.016353725015136
28,28107,7403,172,8060,15635,47.34889670610809,51.55100735529261,1.1000959385992966,52.65110329389191
28,28109,4148,313,19595,24056,17.24309943465248,81.45576987030263,1.3011306950448953,82.75690056534752
28,28111,1362,60,4500,5922,22.99898682877406,75.98784194528876,1.0131712259371835,77.00101317122594
28,28113,8646,235,8479,17360,49.80414746543779,48.84216589861751,1.3536866359447004,50.19585253456221
28,28115,2614,213,11550,14377,18.181818181818183,80.33664881407803,1.4815330041037769,81.81818181818181
28,28117,2139,137,8312,10588,20.202115602568945,78.50396675481677,1.2939176426142804,79.79788439743106
28,28119,2150,53,1026,3229,66.58408175905853,31.774543202229793,1.6413750387116752,33.415918240941465
28,28121,18847,913,50895,70655,26.674686858679497,72.033118675253,1.292194466067511,73.3253131413205
28,28123,4330,129,6285,10744,40.30156366344006,58.49776619508563,1.2006701414743113,59.69843633655994
28,28125,1465,30,688,2183,67.10948236371965,31.5162620247366,1.3742556115437472,32.89051763628035
28,28127,4037,148,7635,11820,34.15397631133672,64.59390862944161,1.2521150592216581,65.84602368866328
28,28129,1791,78,6458,8327,21.508346343220847,77.55494175573436,0.9367119010447942,78.49165365677915
28,28131,1802,112,5964,7878,22.873825844122877,75.70449352627571,1.4216806296014217,77.12617415587712
28,28133,6781,103,2799,9683,70.02994939584839,28.90633068263968,1.0637199215119282,29.97005060415161
28,28135,3105,98,2488,5691,54.55983131259884,43.718151467228964,1.7220172201722017,45.44016868740116
28,28137,4183,211,8707,13101,31.92886039233646,66.46057552858561,1.6105640790779328,68.07113960766354
28,28139,1937,111,8054,10102,19.174420906751138,79.72678677489607,1.0987923183528014,80.82557909324886
28,28141,1059,155,7933,9147,11.577566415218104,86.7278889253307,1.6945446594511864,88.4224335847819
28,28143,2580,59,926,3565,72.37026647966339,25.974754558204772,1.6549789621318374,27.629733520336615
28,28145,2160,150,10373,12683,17.03067097689821,81.78664353859497,1.18268548450682,82.96932902310179
28,28147,2236,59,3426,5721,39.084076210452714,59.88463555322496,1.0312882363223213,60.915923789547286
28,28149,10442,249,10365,21056,49.59156534954408,49.225873860182375,1.1825607902735562,50.40843465045592
28,28151,12503,222,5300,18025,69.36477115117891,29.403606102635226,1.2316227461858529,30.635228848821086
28,28153,3624,134,6307,10065,36.00596125186289,62.66269249875808,1.3313462493790362,63.99403874813711
28,28155,1043,68,4291,5402,19.307663828211773,79.43354313217327,1.2587930396149574,80.69233617178823
28,28157,2749,57,1324,4130,66.56174334140435,32.05811138014528,1.3801452784503632,33.43825665859565
28,28159,4040,92,5112,9244,43.70402423193423,55.30073561228905,0.99524015577672,56.29597576806577
28,28161,2785,82,3671,6538,42.597124502906084,56.1486693178342,1.2542061792597126,57.402875497093916
28,28163,5496,113,4832,10441,52.638636145963034,46.27909204099224,1.0822718130447275,47.361363854036966
29,29001,3705,241,6391,10337,35.842120537873654,61.82644867950082,2.33143078262552,64.15787946212635
29,29003,2351,168,7256,9775,24.051150895140665,74.230179028133,1.7186700767263425,75.94884910485933
29,29005,564,51,2199,2814,20.042643923240938,78.14498933901919,1.812366737739872,79.95735607675905
29,29007,2703,230,7727,10660,25.356472795497186,72.4859287054409,2.1575984990619137,74.64352720450282
29,29009,2948,225,12425,15598,18.899858956276447,79.65764841646364,1.442492627259905,81.10014104372355
29,29011,844,65,5168,6077,13.888431792002635,85.0419614941583,1.0696067138390652,86.11156820799737
29,29013,1672,168,6595,8435,19.8221695317131,78.18612922347363,1.9917012448132778,80.1778304682869
29,29015,2179,193,8106,10478,20.79595342622638,77.36209200229052,1.8419545714831076,79.20404657377362
29,29017,749,70,5162,5981,12.522989466644374,86.30663768600569,1.1703728473499415,87.47701053335562
29,29019,49999,2409,38596,91004,54.94154103116347,42.41132257922728,2.647136389609248,45.05845896883653
29,29021,13445,818,22450,36713,36.621905047258466,61.15000136191539,2.2280935908261377,63.378094952741534
29,29023,3301,265,14599,18165,18.17230938618222,80.36884117808974,1.4588494357280486,81.82769061381778
29,29025,897,74,3725,4696,19.10136286201022,79.32282793867121,1.5758091993185688,80.89863713798978
29,29027,5868,498,14812,21178,27.70799886674851,69.94050429691188,2.3514968363395976,72.29200113325149
29,29029,5640,309,18825,24774,22.765802857834828,75.98692177282635,1.247275369338823,77.23419714216517
29,29031,10738,641,28873,40252,26.676935307562356,71.73059723740435,1.5924674550332905,73.32306469243764
29,29033,785,40,3706,4531,17.325093798278527,81.79209887442066,0.8828073273008166,82.67490620172147
29,29035,418,37,2451,2906,14.384033035099794,84.34273916035788,1.2732278045423262,85.61596696490021
29,29037,19035,1317,37172,57524,33.09053612405257,64.61998470203741,2.28947917391002,66.90946387594744
29,29039,1143,110,5786,7039,16.238102003125444,82.19917601932093,1.5627219775536296,83.76189799687455
29,29041,916,49,3109,4074,22.484045164457537,76.31320569464899,1.202749140893471,77.51595483554246
29,29043,11126,874,34904,46904,23.720791403718234,74.41582807436467,1.8633805219171073,76.27920859628176
29,29045,678,44,2672,3394,19.97642899233942,78.72716558632882,1.296405421331762,80.02357100766058
29,29047,59519,2516,64583,126618,47.00674469664661,51.00617605711668,1.987079246236712,52.99325530335339
29,29049,2894,211,7789,10894,26.565081696346617,71.49807233339452,1.9368459702588583,73.43491830365338
29,29051,12687,733,26066,39486,32.130375322899255,66.01327052626247,1.8563541508382717,67.86962467710075
29,29053,2249,189,6272,8710,25.82089552238806,72.00918484500573,2.1699196326061996,74.17910447761194
29,29055,2113,135,8725,10973,19.256356511437165,79.51335095233756,1.2302925362252801,80.74364348856284
29,29057,656,53,3414,4123,15.910744603444094,82.80378365268008,1.2854717438758185,84.0892553965559
29,29059,1380,122,6620,8122,16.990888943609946,81.50701797586801,1.502093080522039,83.00911105639005
29,29061,740,67,3077,3884,19.05252317198764,79.22245108135942,1.725025746652935,80.94747682801236
29,29063,930,85,3827,4842,19.206939281288722,79.03758777364726,1.7554729450640232,80.79306071871127
29,29065,1056,99,5987,7142,14.78577429291515,83.82805936712406,1.3861663399607953,85.21422570708485
29,29067,1012,86,5896,6994,14.469545324563912,84.30082928224192,1.2296253931941665,85.53045467543609
29,29069,2200,84,8135,10419,21.115270179479797,78.07851041366733,0.806219406852865,78.8847298205202
29,29071,14561,1155,38034,53750,27.090232558139537,70.76093023255814,2.1488372093023256,72.90976744186047
29,29073,1601,111,6222,7934,20.17897655659188,78.42198134610537,1.3990420973027475,79.82102344340812
29,29075,613,46,2580,3239,18.92559431923433,79.65421426366163,1.4201914171040446,81.07440568076566
29,29077,53307,3455,81312,138074,38.60755826585744,58.89016034879847,2.502281385344091,61.39244173414256
29,29079,799,53,3585,4437,18.007662835249043,80.79783637592968,1.1945007888212755,81.99233716475095
29,29081,597,30,3198,3825,15.607843137254902,83.6078431372549,0.7843137254901961,84.3921568627451
29,29083,2615,142,8019,10776,24.266889383815887,74.41536748329621,1.317743132887899,75.73311061618412
29,29085,1054,61,3965,5080,20.748031496062993,78.0511811023622,1.2007874015748032,79.25196850393701
29,29087,338,30,1976,2344,14.419795221843005,84.30034129692832,1.2798634812286689,85.580204778157
29,29089,1412,125,3552,5089,27.746119080369425,69.79760267243074,2.456278247199843,72.25388091963057
29,29091,3214,249,15174,18637,17.245264795836242,81.4186832644739,1.3360519396898642,82.75473520416375
29,29093,945,51,3596,4592,20.579268292682926,78.31010452961672,1.1106271777003485,79.42073170731707
29,29095,198031,6497,125897,330425,59.93220851933116,38.1015359007339,1.9662555799349324,40.06779148066884
29,29097,13539,1262,37714,52515,25.781205369894316,71.81567171284395,2.4031229172617348,74.21879463010569
29,29099,37507,2101,77021,116629,32.159239983194574,66.03932126658036,1.8014387502250726,67.84076001680543
29,29101,6961,705,15468,23134,30.08991095357483,66.86262643727846,3.0474626091467107,69.91008904642517
29,29103,340,30,1486,1856,18.318965517241377,80.0646551724138,1.6163793103448276,81.68103448275862
29,29105,2779,285,13755,16819,16.522979963136926,81.78250787799513,1.694512158867947,83.47702003686308
29,29107,4470,351,12262,17083,26.166364221740913,71.778961540713,2.0546742375460987,73.8336357782591
29,29109,3214,295,14421,17930,17.925264919129948,80.42944785276075,1.6452872281093138,82.07473508087006
29,29111,984,82,3541,4607,21.35880182331235,76.86129802474495,1.7799001519426958,78.64119817668765
29,29113,6553,559,21702,28814,22.742416880683,75.31755396682168,1.9400291524953146,77.257583119317
29,29115,1274,82,4344,5700,22.35087719298246,76.21052631578948,1.4385964912280702,77.64912280701753
29,29117,1409,80,5266,6755,20.85862324204293,77.95706883789786,1.1843079200592153,79.14137675795706
29,29119,1437,148,7465,9050,15.878453038674035,82.48618784530387,1.6353591160220993,84.12154696132596
29,29121,1661,98,6075,7834,21.20245085524636,77.54659177942303,1.25095736533061,78.79754914475365
29,29123,1017,73,4581,5671,17.933345089049553,80.7794039851878,1.287250925762652,82.06665491095045
29,29125,814,70,3890,4774,17.050691244239633,81.48303309593632,1.466275659824047,82.94930875576037
29,29127,3201,259,9910,13370,23.94166043380703,74.12116679132386,1.93717277486911,76.05833956619297
29,29129,222,16,1541,1779,12.478920741989882,86.62169758291175,0.8993816750983699,87.52107925801012
29,29131,2038,166,10175,12379,16.46336537684789,82.19565393004281,1.340980693109298,83.53663462315211
29,29133,1178,41,3537,4756,24.768713204373423,74.36921783010933,0.8620689655172413,75.23128679562657
29,29135,1307,105,5738,7150,18.27972027972028,80.25174825174825,1.4685314685314685,81.72027972027972
29,29137,931,70,3466,4467,20.841728229236626,77.59122453548243,1.567047235280949,79.15827177076338
29,29139,1206,107,4457,5770,20.901213171577123,77.24436741767764,1.8544194107452339,79.09878682842287
29,29141,1924,121,7439,9484,20.286798819063687,78.43736819907213,1.2758329818641925,79.71320118093631
29,29143,1748,53,5447,7248,24.116997792494484,75.15176600441501,0.7312362030905077,75.88300220750551
29,29145,5793,513,22090,28396,20.400760670516974,77.79264685166925,1.8065924778137767,79.59923932948303
29,29147,2849,170,6855,9874,28.853554790358515,69.42475187360745,1.721693336034029,71.14644520964148
29,29149,823,72,3847,4742,17.355546183045128,81.12610712779417,1.5183466891606916,82.64445381695487
29,29151,1031,77,6341,7449,13.84078399785206,85.12552020405424,1.0336957980937038,86.15921600214794
29,29153,752,54,4064,4870,15.441478439425053,83.44969199178645,1.108829568788501,84.55852156057495
29,29155,1556,55,4116,5727,27.169547756242363,71.87008905185961,0.9603631918980269,72.83045224375763
29,29157,1661,134,7634,9429,17.61586594548733,80.96298653091526,1.4211475235974123,82.38413405451267
29,29159,4776,458,13835,19069,25.045885992972888,72.55231003198908,2.40180397503802,74.95411400702712
29,29161,5619,438,13438,19495,28.822775070530902,68.93049499871762,2.2467299307514748,71.1772249294691
29,29163,1717,113,5856,7686,22.339318240957585,76.19047619047619,1.4702055685662243,77.66068175904242
29,29165,28111,1161,29251,58523,48.034106248825246,49.98205833603882,1.9838354151359296,51.965893751174754
29,29167,2883,327,11849,15059,19.1446975230759,78.68384354870841,2.171458928215685,80.8553024769241
29,29169,3735,344,10326,14405,25.928497049635542,71.68344324887191,2.3880597014925375,74.07150295036446
29,29171,361,16,1984,2361,15.290131300296483,84.03218975010589,0.6776789495976281,84.70986869970352
29,29173,1205,61,4396,5662,21.282232426704343,77.64040974920523,1.0773578240904276,78.71776757329566
29,29175,2485,239,8018,10742,23.133494693725563,74.6415937441817,2.22491156209272,76.86650530627443
29,29177,3107,219,8328,11654,26.660374120473655,71.46044276643212,1.8791831130942165,73.33962587952635
29,29179,529,36,2733,3298,16.04002425712553,82.86840509399637,1.0915706488781078,83.95997574287446
29,29181,833,72,4838,5743,14.504614313076788,84.24168553021069,1.2537001567125197,85.49538568692321
29,29183,89346,4636,128193,222175,40.214245527174526,57.69911106110048,2.0866434117249915,59.785754472825474
29,29185,988,54,3930,4972,19.87127916331456,79.04263877715205,1.0860820595333869,80.12872083668543
29,29186,2713,155,6627,9495,28.572933122696153,69.79462875197471,1.6324381253291207,71.42706687730384
29,29187,7044,446,20506,27996,25.16073724817831,73.2461780254322,1.593084726389484,74.83926275182169
29,29189,322802,8465,196808,528075,61.12805946125077,37.268948539506695,1.6029919992425319,38.87194053874923
29,29195,2903,178,6447,9528,30.468094038623008,67.66372795969772,1.868178001679261,69.53190596137699
29,29197,373,26,1606,2005,18.60349127182045,80.0997506234414,1.2967581047381544,81.39650872817955
29,29199,387,38,1560,1985,19.496221662468514,78.58942065491183,1.9143576826196476,80.50377833753149
29,29201,3753,226,13769,17748,21.146044624746448,77.5805724588686,1.2733829163849448,78.85395537525355
29,29203,706,38,3164,3908,18.065506653019447,80.96212896622313,0.9723643807574206,81.93449334698056
29,29205,592,64,2699,3355,17.645305514157975,80.44709388971684,1.9076005961251863,82.35469448584203
29,29207,1814,136,11460,13410,13.527218493661447,85.4586129753915,1.0141685309470545,86.47278150633855
29,29209,3486,176,14716,18378,18.968331700946784,80.07400152356078,0.9576667754924366,81.03166829905322
29,29211,478,19,1974,2471,19.34439498178875,79.88668555240793,0.7689194658033185,80.65560501821125
29,29213,5325,489,20426,26240,20.29344512195122,77.84298780487805,1.8635670731707317,79.70655487804878
29,29215,1716,138,9478,11332,15.142957995058243,83.63925167666785,1.2177903282739144,84.85704200494176
29,29217,1902,127,7135,9164,20.75512876473156,77.85901353120907,1.3858577040593627,79.24487123526845
29,29219,4769,382,13222,18373,25.95656670113754,71.96429543351658,2.079137865345888,74.04343329886245
29,29221,1804,121,8046,9971,18.09246815765721,80.69401263664628,1.21351920569652,81.90753184234279
29,29223,844,46,4984,5874,14.368403132448076,84.84848484848484,0.7831120190670752,85.63159686755192
29,29225,3572,330,14874,18776,19.024286322965487,79.21815083084789,1.757562846186621,80.97571367703452
29,29227,215,15,877,1107,19.421860885275517,79.22312556458898,1.3550135501355014,80.57813911472448
29,29229,1167,118,7452,8737,13.35698752432185,85.29243447407578,1.3505780016023807,86.64301247567815
29,29510,108385,2195,21185,131765,82.25628960649641,16.077865897620764,1.6658444958828216,17.74371039350359
30,30001,1608,130,3923,5661,28.404875463698993,69.29871047518105,2.2964140611199437,71.595124536301
30,30003,2491,86,2207,4784,52.06939799331104,46.13294314381271,1.797658862876254,47.93060200668896
30,30005,1589,63,1469,3121,50.91316885613585,47.068247356616475,2.018583787247677,49.08683114386415
30,30007,835,89,3173,4097,20.380766414449596,77.44691237490848,2.172321210641933,79.6192335855504
30,30009,2421,212,4468,7101,34.09378960709759,62.920715392198275,2.9854950007041263,65.90621039290241
30,30011,74,15,775,864,8.564814814814815,89.69907407407408,1.7361111111111112,91.43518518518519
30,30013,15456,1114,23314,39884,38.75238190753184,58.454518102497246,2.7930999899709157,61.24761809246816
30,30015,988,91,1888,2967,33.29962925513988,63.633299629255134,3.067071115604988,66.70037074486012
30,30017,1514,164,4205,5883,25.735169131395548,71.47713751487336,2.7876933537310897,74.26483086860445
30,30019,195,20,799,1014,19.230769230769234,78.79684418145956,1.9723865877712032,80.76923076923077
30,30021,962,117,3758,4837,19.888360554062434,77.69278478395701,2.4188546619805664,80.11163944593757
30,30023,2562,143,2186,4891,52.38192598650583,44.694336536495605,2.9237374769985687,47.61807401349417
30,30025,172,28,1375,1575,10.920634920634921,87.3015873015873,1.7777777777777777,89.07936507936508
30,30027,1496,166,4869,6531,22.90613994794059,74.55213596692697,2.5417240851324454,77.09386005205941
30,30029,20274,1663,38321,60258,33.645325102061136,63.59487536924557,2.7597995286932857,66.35467489793886
30,30031,37044,2767,31696,71507,51.80471841917574,44.32573034807781,3.8695512327464447,48.19528158082426
30,30033,41,8,764,813,5.043050430504305,93.9729397293973,0.984009840098401,94.95694956949569
30,30035,3610,145,1884,5639,64.0184429863451,33.410179109771235,2.571377903883667,35.98155701365491
30,30037,78,11,414,503,15.50695825049702,82.30616302186878,2.1868787276341948,84.49304174950298
30,30039,638,45,1419,2102,30.352045670789725,67.5071360608944,2.1408182683158894,69.64795432921028
30,30041,2981,244,3957,7182,41.50654413812308,55.09607351712616,3.3973823447507656,58.49345586187692
30,30043,2625,221,5345,8191,32.047369063606396,65.25454767427664,2.698083262116958,67.9526309363936
30,30045,275,29,1040,1344,20.461309523809522,77.38095238095238,2.1577380952380953,79.53869047619048
30,30047,6916,388,9322,16626,41.597497894863466,56.06880789125466,2.3336942138818717,58.402502105136534
30,30049,19743,1333,21409,42485,46.47051900670825,50.39190302459692,3.137577968694834,53.52948099329175
30,30051,249,13,821,1083,22.99168975069252,75.80794090489381,1.2003693444136658,77.00831024930748
30,30053,2835,240,8672,11747,24.13382140120882,73.82310377117562,2.0430748276155613,75.86617859879118
30,30055,155,17,956,1128,13.741134751773048,84.75177304964538,1.5070921985815602,86.25886524822695
30,30057,1771,151,4191,6113,28.971045313266806,68.55880909537052,2.4701455913626695,71.02895468673319
30,30059,258,19,833,1110,23.243243243243246,75.04504504504504,1.7117117117117115,76.75675675675676
30,30061,686,49,1828,2563,26.765509168942646,71.32266874756145,1.911822083495903,73.23449083105736
30,30063,43357,2282,26347,71986,60.22976689911928,36.60017225571639,3.1700608451643375,39.77023310088072
30,30065,413,45,2423,2881,14.335300242971192,84.10274210343631,1.5619576535925026,85.66469975702881
30,30067,5280,313,6025,11618,45.44672060595627,51.859184024789116,2.694095369254605,54.55327939404373
30,30069,39,14,298,351,11.11111111111111,84.9002849002849,3.9886039886039883,88.88888888888889
30,30071,416,34,1936,2386,17.435037720033527,81.13998323554065,1.4249790444258172,82.56496227996647
30,30073,903,61,2031,2995,30.150250417362273,67.81302170283806,2.036727879799666,69.84974958263773
30,30075,154,12,970,1136,13.556338028169016,85.38732394366197,1.056338028169014,86.44366197183098
30,30077,752,88,2347,3187,23.59585817383119,73.64292438029494,2.7612174458738625,76.40414182616881
30,30079,126,15,603,744,16.93548387096774,81.04838709677419,2.0161290322580645,83.06451612903226
30,30081,8763,630,19114,28507,30.739818290244504,67.05019819693409,2.2099835128214123,69.2601817097555
30,30083,875,123,4800,5798,15.091410831321145,82.78716798896171,2.121421179717144,84.90858916867886
30,30085,1910,122,1996,4028,47.41807348560079,49.55312810327706,3.028798411122145,52.58192651439921
30,30087,1199,99,2486,3784,31.686046511627907,65.69767441860465,2.616279069767442,68.31395348837209
30,30089,1820,172,5660,7652,23.78463146889702,73.96759017250392,2.247778358599059,76.21536853110298
30,30091,574,53,1403,2030,28.27586206896552,69.11330049261085,2.610837438423645,71.72413793103448
30,30093,10392,690,7745,18827,55.19732299357306,41.137727731449516,3.664949274977426,44.80267700642694
30,30095,1156,123,4462,5741,20.135864831910816,77.72165128026475,2.142483887824421,79.86413516808918
30,30097,549,57,1840,2446,22.444807849550287,75.22485690923958,2.3303352412101392,77.55519215044971
30,30099,1007,80,2608,3695,27.253044654939107,70.58186738836265,2.165087956698241,72.7469553450609
30,30101,467,60,1596,2123,21.99717381064531,75.17663683466792,2.8261893546867642,78.00282618935469
30,30103,78,9,373,460,16.956521739130434,81.08695652173913,1.956521739130435,83.04347826086956
30,30105,1030,107,3135,4272,24.11048689138577,73.38483146067416,2.5046816479400746,75.88951310861424
30,30107,225,20,823,1068,21.06741573033708,77.05992509363297,1.8726591760299627,78.93258426966293
30,30109,77,5,516,598,12.876254180602006,86.2876254180602,0.8361204013377926,87.123745819398
30,30111,30679,2370,50772,83821,36.60061321148638,60.57193304780425,2.8274537407093687,63.39938678851362
31,31001,4213,304,10085,14602,28.852212025749896,69.0658813861115,2.081906588138611,71.14778797425011
31,31003,452,38,3093,3583,12.615126988557074,86.32430923806865,1.0605637733742674,87.38487301144292
31,31005,21,3,260,284,7.394366197183098,91.54929577464789,1.056338028169014,92.6056338028169
31,31007,43,5,362,410,10.487804878048781,88.29268292682927,1.2195121951219512,89.51219512195122
31,31009,35,2,280,317,11.041009463722396,88.32807570977917,0.6309148264984227,88.95899053627761
31,31011,499,65,2653,3217,15.511345974510412,82.46813801678583,2.0205160087037615,84.48865402548958
31,31013,1051,128,4002,5181,20.285659139162323,77.24377533294731,2.4705655278903684,79.71434086083768
31,31015,135,8,1010,1153,11.70858629661752,87.5975715524718,0.6938421509106678,88.29141370338247
31,31017,191,18,1470,1679,11.375818939845146,87.55211435378202,1.0720667063728408,88.62418106015485
31,31019,6350,599,16640,23589,26.919326804866678,70.54135402094197,2.5393191741913603,73.08067319513333
31,31021,1063,88,2580,3731,28.491021173948006,69.15036183328867,2.3586169927633343,71.50897882605199
31,31023,869,83,3526,4478,19.405984814649397,78.74050915587316,1.8535060294774455,80.5940151853506
31,31025,4737,426,10121,15284,30.99319549856059,66.21957602721801,2.7872284742214077,69.0068045014394
31,31027,725,97,4174,4996,14.511609287429945,83.54683746997597,1.9415532425940754,85.48839071257005
31,31029,226,27,1740,1993,11.339688911189162,87.30556949322629,1.3547415955845459,88.66031108881084
31,31031,373,48,2844,3265,11.424196018376723,87.10566615620215,1.4701378254211332,88.57580398162328
31,31033,855,97,3813,4765,17.94333683105981,80.02098635886674,2.0356768100734524,82.05666316894019
31,31035,632,78,2848,3558,17.762788083192802,80.0449690837549,2.1922428330522767,82.2372119168072
31,31037,1025,65,2636,3726,27.509393451422437,70.74610842726786,1.7444981213097157,72.49060654857756
31,31039,870,74,3507,4451,19.5461694001348,78.79128285778478,1.6625477420804315,80.4538305998652
31,31041,768,113,4996,5877,13.067891781521185,85.00935851624979,1.9227497022290283,86.93210821847882
31,31043,2744,124,3926,6794,40.38857815719753,57.78628201354136,1.8251398292611127,59.61142184280247
31,31045,1082,108,2931,4121,26.255763164280516,71.12351371026449,2.6207231254549868,73.74423683571948
31,31047,2497,157,6524,9178,27.20636304205709,71.08302462410111,1.7106123338417958,72.79363695794291
31,31049,141,20,871,1032,13.662790697674417,84.39922480620154,1.937984496124031,86.33720930232559
31,31051,651,97,2335,3083,21.115796302302954,75.7379176127149,3.1462860849821603,78.88420369769705
31,31053,5526,346,10963,16835,32.82447282447282,65.12028512028512,2.055242055242055,67.17552717552718
31,31055,150309,5443,119117,274869,54.683867587832744,43.3359163819856,1.98021603018165,45.316132412167256
31,31057,105,11,883,999,10.51051051051051,88.38838838838838,1.1011011011011012,89.48948948948949
31,31059,693,82,2359,3134,22.112316528398214,75.27121888959796,2.6164645820038293,77.88768347160179
31,31061,276,11,1434,1721,16.037187681580477,83.3236490412551,0.6391632771644393,83.96281231841952
31,31063,189,22,1229,1440,13.125,85.34722222222221,1.5277777777777777,86.875
31,31065,399,39,2163,2601,15.340253748558247,83.1603229527105,1.4994232987312572,84.65974625144176
31,31067,3385,238,7445,11068,30.583664618720636,67.2659920491507,2.150343332128659,69.41633538127937
31,31069,161,18,1016,1195,13.472803347280335,85.02092050209204,1.506276150627615,86.52719665271967
31,31071,133,9,925,1067,12.46485473289597,86.69165885660732,0.8434864104967198,87.53514526710403
31,31073,215,10,893,1118,19.230769230769234,79.87477638640429,0.8944543828264758,80.76923076923077
31,31075,20,7,375,402,4.975124378109453,93.28358208955224,1.7412935323383085,95.02487562189054
31,31077,229,13,1016,1258,18.20349761526232,80.7631160572337,1.0333863275039745,81.79650238473768
31,31079,7681,504,16189,24374,31.513087716419136,66.4191351440059,2.067777139574957,68.48691228358086
31,31081,1117,106,4297,5520,20.23550724637681,77.84420289855073,1.9202898550724639,79.76449275362319
31,31083,282,31,1615,1928,14.626556016597512,83.7655601659751,1.6078838174273857,85.3734439834025
31,31085,34,6,494,534,6.367041198501873,92.50936329588015,1.1235955056179776,93.63295880149812
31,31087,175,30,1264,1469,11.91286589516678,86.044928522804625,2.042205582028591,88.08713410483323
31,31089,686,82,4769,5537,12.389380530973451,86.12967310818132,1.480946360845223,87.61061946902655
31,31091,59,7,376,442,13.34841628959276,85.06787330316742,1.583710407239819,86.65158371040724
31,31093,648,67,2786,3501,18.50899742930591,79.57726363896029,1.9137389317337903,81.49100257069409
31,31095,1016,84,2616,3716,27.341227125941874,70.39827771797633,2.2604951560818085,72.65877287405813
31,31097,647,64,1518,2229,29.02646926873037,68.10228802153432,2.871242709735307,70.97353073126963
31,31099,701,81,2822,3604,19.450610432852386,78.30188679245283,2.2475027746947833,80.54938956714761
31,31101,763,57,3544,4364,17.4839596700275,81.20989917506874,1.306141154903758,82.5160403299725
31,31103,49,4,476,529,9.262759924385634,89.98109640831758,0.7561436672967864,90.73724007561437
31,31105,267,40,1553,1860,14.35483870967742,83.49462365591398,2.1505376344086025,85.64516129032258
31,31107,905,71,3721,4697,19.267617628273364,79.22077922077922,1.5116031509474133,80.73238237172663
31,31109,82293,3706,70092,156091,52.72116906163712,44.904574895413575,2.3742560429493054,47.27883093836288
31,31111,3692,344,13071,17107,21.581808616355875,76.40731864149178,2.0108727421523356,78.41819138364413
31,31113,38,5,407,450,8.444444444444445,90.44444444444444,1.1111111111111112,91.55555555555556
31,31115,75,9,370,454,16.519823788546255,81.4977973568282,1.9823788546255507,83.48017621145374
31,31117,17,10,275,302,5.629139072847682,91.05960264900662,3.3112582781456954,94.37086092715232
31,31119,3393,336,11678,15407,22.022457324592718,75.79671577854222,2.1808268968650615,77.97754267540728
31,31121,740,120,3407,4267,17.34239512538083,79.84532458401688,2.812280290602297,82.65760487461917
31,31123,386,59,2113,2558,15.089913995308834,82.60359655981236,2.3064894448788116,84.91008600469117
31,31125,359,32,1437,1828,19.63894967177243,78.61050328227572,1.75054704595186,80.36105032822758
31,31127,921,74,2428,3423,26.906222611744084,70.93193105463044,2.1618463336254745,73.09377738825592
31,31129,409,37,1857,2303,17.7594442032132,80.63395570994355,1.606600086843248,82.2405557967868
31,31131,2490,176,5649,8315,29.94588093806374,67.9374624173181,2.11665664461816,70.05411906193626
31,31133,322,36,1071,1429,22.533240027991603,74.94751574527642,2.5192442267319803,77.46675997200839
31,31135,199,24,1321,1544,12.888601036269431,85.55699481865285,1.5544041450777202,87.11139896373057
31,31137,752,100,4157,5009,15.01297664204432,82.99061688959873,1.9964064683569576,84.98702335795568
31,31139,480,64,3462,4006,11.982026959560658,86.42036944583126,1.597603594608088,88.01797304043934
31,31141,3208,221,11836,15265,21.015394693743858,77.53684900098264,1.4477563052735014,78.98460530625614
31,31143,527,57,2286,2870,18.362369337979096,79.65156794425087,1.986062717770035,81.63763066202091
31,31145,811,116,4525,5452,14.87527512839325,82.99706529713866,2.127659574468085,85.12472487160674
31,31147,996,57,3073,4126,24.139602520601066,74.47891420261755,1.3814832767813863,75.86039747939893
31,31149,84,13,744,841,9.988109393579073,88.46611177170035,1.5457788347205708,90.01189060642093
31,31151,1986,153,3631,5770,34.41941074523397,62.92894280762565,2.651646447140381,65.58058925476604
31,31153,41029,2862,51518,95409,43.00328061294008,53.99700237923047,2.99971700782945,56.99671938705992
31,31155,3331,296,9108,12735,26.156262269336473,71.51943462897526,2.324303101688261,73.84373773066352
31,31157,4196,321,10952,15469,27.125218178292066,70.79966384381666,2.0751179778912663,72.87478182170793
31,31159,2438,214,6490,9142,26.668125136731568,70.99103040910086,2.340844454167578,73.33187486326844
31,31161,340,40,2292,2672,12.724550898203594,85.77844311377245,1.4970059880239521,87.27544910179641
31,31163,343,33,1322,1698,20.200235571260304,77.85630153121319,1.9434628975265018,79.79976442873969
31,31165,72,15,642,729,9.876543209876543,88.06584362139918,2.05761316872428,90.12345679012346
31,31167,532,72,2561,3165,16.808846761453395,80.91627172195892,2.2748815165876777,83.1911532385466
31,31169,624,48,2308,2980,20.93959731543624,77.4496644295302,1.6107382550335572,79.06040268456375
31,31171,45,5,377,427,10.53864168618267,88.2903981264637,1.1709601873536302,89.46135831381733
31,31173,1122,23,1180,2325,48.25806451612903,50.752688172043015,0.9892473118279571,51.74193548387097
31,31175,412,27,1901,2340,17.60683760683761,81.23931623931624,1.153846153846154,82.39316239316238
31,31177,3554,276,8583,12413,28.63127366470636,69.14525094658825,2.2234753887053893,71.36872633529364
31,31179,1022,123,3055,4200,24.333333333333336,72.73809523809524,2.928571428571429,75.66666666666666
31,31181,335,30,1511,1876,17.857142857142858,80.54371002132196,1.5991471215351813,82.14285714285714
31,31183,59,5,438,502,11.752988047808765,87.25099601593625,0.9960159362549801,88.24701195219123
31,31185,1619,174,5296,7089,22.838200028212725,74.7072929891381,2.4545069826491748,77.16179997178727
32,32001,3051,467,9372,12890,23.669511249030258,72.70752521334369,3.6229635376260663,76.33048875096975
32,32003,521852,19728,430930,972510,53.66032225889709,44.31111248213386,2.0285652589690595,46.33967774110291
32,32005,11571,924,21630,34125,33.90769230769231,63.38461538461539,2.707692307692308,66.09230769230768
32,32007,4557,669,16741,21967,20.74475349387718,76.20976919925343,3.045477306869395,79.25524650612282
32,32009,74,13,400,487,15.195071868583163,82.13552361396303,2.6694045174537986,84.80492813141683
32,32011,105,17,895,1017,10.32448377581121,88.00393313667651,1.671583087512291,89.67551622418878
32,32013,1689,205,5877,7771,21.734654484622315,75.62733238965384,2.638013125723845,78.26534551537769
32,32015,496,71,2198,2765,17.93851717902351,79.49367088607595,2.5678119349005426,82.0614828209765
32,32017,330,49,2067,2446,13.49141455437449,84.50531479967293,2.0032706459525755,86.50858544562551
32,32019,8473,851,20914,30238,28.021033137112244,69.16462729016469,2.814339572723064,71.97896686288776
32,32021,829,83,1423,2335,35.50321199143469,60.94218415417559,3.5546038543897214,64.49678800856532
32,32023,7288,562,17528,25378,28.717787059657972,69.06769642997872,2.214516510363307,71.28221294034202
32,32027,547,42,1731,2320,23.57758620689655,74.61206896551724,1.810344827586207,76.42241379310344
32,32029,902,67,1908,2877,31.352102884949602,66.31908237747653,2.3288147375738615,68.6478971150504
32,32031,128128,7254,116760,252142,50.81581013873135,46.307239571352646,2.876950289916,49.18418986126865
32,32033,859,107,3403,4369,19.66124971389334,77.88967727168689,2.449073014419776,80.33875028610666
32,32510,12735,891,16113,29739,42.82255623928175,54.181377988499946,2.9960657722182993,57.17744376071825
33,33001,16894,660,20899,38453,43.934153382050816,54.349465581359055,1.716381036590123,56.065846617949184
33,33003,16649,473,16150,33272,50.0390718922818,48.539312334695836,1.421615773022361,49.9609281077182
33,33005,25522,809,17898,44229,57.70422121232676,40.46666214474666,1.8291166429265866,42.29577878767324
33,33007,7640,271,8617,16528,46.22458857696031,52.13576960309777,1.6396418199419167,53.77541142303969
33,33009,33180,904,19905,53989,61.45696345551872,36.868621385837855,1.6744151586434275,38.54303654448128
33,33011,122344,4071,104625,231040,52.95360110803324,45.284366343490305,1.7620325484764543,47.04639889196676
33,33013,48533,1643,39711,89887,53.99334720259882,44.1788022739662,1.8278505234349793,46.00665279740118
33,33015,100064,3021,95858,198943,50.29782399983915,48.18365059338605,1.5185254067748049,49.70217600016085
33,33017,41721,1519,30489,73729,56.5869603548129,41.35279198144556,2.06024766374154,43.4130396451871
33,33019,12390,485,11508,24383,50.81409178526022,47.196817454784075,1.989090759955707,49.18590821473978
34,34001,73289,2180,64054,139523,52.52825698988697,45.90927660672434,1.5624664033886886,47.47174301011303
34,34003,285811,7072,204277,497160,57.48873602059699,41.088784294794436,1.4224796846085768,42.51126397940301
34,34005,145987,3857,96583,246427,59.241479221026914,39.193351377892846,1.5651694010802388,40.758520778973086
34,34007,174575,4313,86024,264912,65.89924201244187,32.472670169716736,1.6280878178413962,34.100757987558126
34,34009,23837,615,33005,57457,41.48667699322972,57.44295734201229,1.0703656647579929,58.51332300677028
34,34011,32689,879,28904,62472,52.32584197720579,46.26712767319759,1.4070303495966192,47.67415802279421
34,34013,237981,2696,68038,308715,77.0876050726398,22.039097549519784,0.8732973778404031,22.912394927360197
34,34015,86702,3411,83340,173453,49.985875136204044,48.04759790836711,1.9665269554288483,50.014124863795956
34,34017,180594,3288,65291,249173,72.47735509063983,26.2030797879385,1.3195651214216628,27.522644909360167
34,34019,38658,2004,42203,82865,46.651783020575635,50.929825619984314,2.418391359440053,53.348216979424365
34,34021,112845,2887,47788,163520,69.00990704500978,29.22455968688845,1.7655332681017613,30.990092954990217
34,34023,208902,5035,130801,344738,60.597323184563344,37.9421473698867,1.4605294455499538,39.40267681543666
34,34025,179245,5216,189359,373820,47.949547910759186,50.6551281365363,1.39532395270451,52.050452089240814
34,34027,149999,5756,137845,293600,51.08957765667574,46.94993188010899,1.960490463215259,48.91042234332426
34,34029,113359,5064,203613,322036,35.20072290054528,63.226782098895775,1.5724950005589438,64.79927709945471
34,34031,118112,2992,84873,205977,57.34232462847794,41.205086004748104,1.4525893667739602,42.65767537152206
34,34033,13722,684,18042,32448,42.28920118343195,55.60281065088757,2.1079881656804735,57.71079881656805
34,34035,103875,3430,67335,174640,59.4795006871278,38.55645900137426,1.9640403114979388,40.5204993128722
34,34037,34417,2165,51566,88148,39.044561419430956,58.49934201570086,2.4560965648681763,60.955438580569044
34,34039,168495,3774,79185,251454,67.00827984442482,31.490849220931068,1.5008709346441098,32.99172015557518
34,34041,23861,1323,32998,58182,41.01096559073253,56.7151352652023,2.2738991440651746,58.98903440926747
35,35001,193756,7698,116135,317589,61.00841024090885,36.56770228188004,2.4238874772111125,38.99158975909115
35,35003,595,33,1698,2326,25.580395528804818,73.00085984522786,1.4187446259673258,74.41960447119519
35,35005,6381,406,15656,22443,28.43202780376955,69.75894488259145,1.8090273136389965,71.56797219623044
35,35006,4745,183,3975,8903,53.29664158148939,44.64787150398742,2.0554869145231947,46.70335841851061
35,35007,2611,134,3271,6016,43.400930851063826,54.371675531914896,2.2273936170212765,56.599069148936174
35,35009,4307,350,10444,15101,28.52128998079597,69.1609827163764,2.317727302827627,71.47871001920403
35,35011,231,14,656,901,25.638179800221977,72.8079911209767,1.553829078801332,74.36182019977802
35,35013,47958,1882,32800,82640,58.032429816069694,39.690222652468535,2.277347531461762,41.967570183930306
35,35015,5424,344,17454,23222,23.357161312548445,75.16148479889759,1.4813538885539574,76.64283868745156
35,35017,7590,292,6553,14435,52.580533425701425,45.39660547280914,2.0228611014894353,47.419466574298575
35,35019,1234,38,917,2189,56.37277295568753,41.89127455459114,1.7359524897213339,43.62722704431247
35,35021,179,7,319,505,35.445544554455445,63.16831683168317,1.3861386138613863,64.55445544554456
35,35023,821,31,1117,1969,41.69629253428136,56.72930421533774,1.5744032503809042,58.30370746571864
35,35025,4061,326,16531,20918,19.41390190266756,79.02763170475188,1.5584663925805526,80.58609809733244
35,35027,3194,170,6942,10306,30.991655346400155,67.35882010479332,1.6495245488065204,69.00834465359985
35,35028,7554,461,4278,12293,61.44960546652567,34.8002928495892,3.7501016838851378,38.55039453347433
35,35029,3565,132,4407,8104,43.99062191510365,54.38055281342547,1.6288252714708784,56.00937808489635
35,35031,17969,655,7782,26406,68.04892827387715,29.470574869347878,2.4804968567749754,31.951071726122848
35,35033,1744,37,902,2683,65.00186358553857,33.619083115915025,1.3790532985464032,34.99813641446143
35,35035,8485,565,14521,23571,35.997624199227864,61.605362521742826,2.3970132790293155,64.00237580077214
35,35037,1170,69,2634,3873,30.20914020139427,68.00929512006196,1.7815646785437647,69.79085979860574
35,35039,10990,230,5408,16628,66.0933365407746,32.52345441424104,1.3832090449843637,33.9066634592254
35,35041,1802,172,4634,6608,27.269975786924938,70.12711864406779,2.602905569007264,72.73002421307507
35,35043,40588,1800,34174,76562,53.01324416812518,44.635720070008624,2.3510357618662,46.98675583187482
35,35045,18081,1338,32874,52293,34.57632952785268,62.865010613275196,2.5586598588721245,65.42367047214732
35,35047,7888,222,3421,11531,68.40690313069118,29.66785187754748,1.925244991761339,31.593096869308823
35,35049,62530,1368,18329,82227,76.04558113515026,22.29073175477641,1.6636871100733335,23.954418864849742
35,35051,2265,138,3542,5945,38.09924306139613,59.579478553406226,2.3212783851976453,61.90075693860387
35,35053,3722,183,3255,7160,51.98324022346369,45.460893854748605,2.5558659217877095,48.01675977653631
35,35055,13030,342,3663,17035,76.48958027590255,21.50278837687115,2.0076313472262988,23.510419724097446
35,35057,2344,165,4772,7281,32.19338003021563,65.54044774069496,2.266172229089411,67.80661996978438
35,35059,383,18,1388,1789,21.40860816098379,77.58524315259922,1.0061486864169928,78.59139183901621
35,35061,14263,650,17363,32276,44.190729954145496,53.79538976329161,2.013880282562895,55.809270045854504
36,36001,73189,2770,45570,121529,60.223485752371865,37.4972228850727,2.2792913625554396,39.776514247628135
36,36003,4188,413,12670,17271,24.24874066354004,73.35996757570494,2.391291760755023,75.75125933645995
36,36005,271835,1954,55849,329638,82.4647037052767,16.942524830268354,0.5927714644549475,17.535296294723295
36,36007,32275,1750,38351,72376,44.5935116613242,52.9885597435614,2.4179285951144025,55.4064883386758
36,36009,9142,614,20295,30051,30.4216165851386,67.535190176699615,2.0431932381617917,69.5783834148614
36,36011,16143,795,19495,36433,44.308731095435455,53.50918123679082,2.1820876677737218,55.691268904564545
36,36013,23075,1362,34846,59283,38.92346878531788,58.77907663242413,2.297454582257983,61.07653121468212
36,36015,11573,685,19388,31646,36.57018264551602,61.26524679264362,2.164570561840359,63.42981735448398
36,36017,5126,415,11736,17277,29.669502807200328,67.92845980204896,2.402037390750709,70.33049719279967
36,36019,12690,427,14354,27471,46.1941683957628,52.251465181464084,1.5543664227731062,53.8058316042372
36,36021,19764,642,14235,34641,57.05378020265004,41.09292456915216,1.8532952281978001,42.94621979734996
36,36023,10367,520,10788,21675,47.82929642445213,49.77162629757785,2.3990772779700116,52.17070357554787
36,36025,6420,391,11952,18763,34.216276714811066,63.69983478121836,2.0838885039705803,65.78372328518893
36,36027,57720,2158,59661,119539,48.285496783476525,49.90923464308719,1.8052685734362843,51.714503216523475
36,36029,198808,6795,178349,383952,51.77938909030295,46.45085844063841,1.7697524690586324,48.22061090969705
36,36031,6970,262,7953,15185,45.90055976292394,52.374053342113925,1.7253868949621338,54.09944023707606
36,36033,6586,281,8530,15397,42.77456647398844,55.40040267584594,1.8250308501656167,57.22543352601156
36,36035,5804,387,13989,20180,28.761149653121905,69.3211100099108,1.9177403369672945,71.2388503468781
36,36037,7048,616,17340,25004,28.18749000159975,69.34890417533195,2.463605823068309,71.81250999840026
36,36039,7675,485,12722,20882,36.75414232353223,60.92328321042045,2.3225744660473135,63.24585767646777
36,36041,1178,57,2225,3460,34.04624277456648,64.30635838150289,1.6473988439306357,65.95375722543352
36,36043,7282,446,17038,24766,29.403214083824597,68.79592990390051,1.800856012274893,70.5967859161754
36,36045,12053,698,22779,35530,33.92344497607655,64.1120180129468,1.9645370109766396,66.07655502392345
36,36047,514133,5073,174731,693937,74.08929052637343,25.17966328355456,0.7310461900720094,25.910709473626568
36,36049,2768,179,7931,10878,25.44585401728259,72.90862290862292,1.6455230740945026,74.55414598271742
36,36051,12401,811,18139,31351,39.55535708589837,57.85780357883321,2.5868393352684125,60.44464291410163
36,36053,14682,895,18385,33962,43.230669571874444,54.13403215358341,2.6352982745421354,56.769330428125556
36,36055,223936,9535,145290,378761,59.12329938932467,38.35928197464892,2.5174186360264126,40.87670061067533
36,36057,5746,369,11500,17615,32.619926199262,65.28526823729776,2.09480556344025,67.380073800738
36,36059,348355,8538,308765,665658,52.33242896502408,46.38493039969474,1.2826406352811803,47.66757103497592
36,36061,377605,4255,65001,446861,84.501668304014,14.546134032730537,0.9521976632554642,15.498331695985996
36,36063,34809,1657,51355,87821,39.636305667209434,58.47690187996037,1.8867924528301887,60.363694332790566
36,36065,30542,1607,51950,84099,36.316721958643974,61.772434868428874,1.9108431729271453,63.683278041356026
36,36067,113970,5267,84117,203354,56.045123282551614,41.36481210106514,2.590064616383253,43.954876717448386
36,36069,20779,1294,25757,47830,43.443445536274304,53.85113945222664,2.7054150114990594,56.556554463725696
36,36071,61868,1870,76218,139956,44.20532167252565,54.45854411386436,1.3361342136099918,55.79467832747435
36,36073,4082,370,11173,15625,26.124799999999997,71.5072,2.368,73.8752
36,36075,14698,1054,28930,44682,32.89467794637662,64.74643032988675,2.358891723736628,67.10532205362338
36,36077,12986,723,14366,28075,46.254674977738205,51.17008014247551,2.5752448797862866,53.745325022261795
36,36079,20266,745,26888,47899,42.309860331113384,56.13478360717343,1.555356061713188,57.690139668886616
36,36081,412393,4310,181225,597928,68.97034425549565,30.30883317054896,0.7208225739553926,31.029655744504353
36,36083,30450,1464,33371,65285,46.64164815807613,51.115876541318826,2.2424753006050393,53.35835184192387
36,36085,67223,1434,110094,178751,37.6070623381128,61.59070438766776,0.802233274219445,62.3929376618872
36,36087,50926,1268,63830,116024,43.89264290146866,55.0144797628077,1.0928773357236434,56.10735709853134
36,36089,13036,621,21862,35519,36.70148371294237,61.550156254399056,1.748360032658577,63.29851628705763
36,36091,49697,2638,55248,107583,46.194101298532296,51.35383843172249,2.45206026974522,53.805898701467704
36,36093,31685,1362,27544,60591,52.29324487135053,45.458896535789144,2.247858592860326,47.70675512864947
36,36095,4006,358,9010,13374,29.953641393749063,67.36952295498729,2.6768356512636458,70.04635860625093
36,36097,3902,242,5620,9764,39.9631298648095,57.55837771405162,2.4784924211388772,60.0368701351905
36,36099,5076,296,7582,12954,39.18480778138027,58.53018372703412,2.285008491585611,60.81519221861973
36,36101,11299,717,26781,38797,29.123385828801197,69.02853313400522,1.8480810371935976,70.87661417119881
36,36103,259463,8181,333617,601261,43.153139817816225,55.486219794731404,1.360640387452371,56.846860182183775
36,36105,10995,381,15555,26931,40.826556756154616,57.75871672050796,1.4147265233374178,59.173443243845384
36,36107,9498,655,14616,24769,38.346319996770156,59.00924542775243,2.644434575477411,61.653680003229844
36,36109,22624,751,9640,33015,68.52642738149326,29.198849008026656,2.274723610480085,31.473572618506736
36,36111,42606,1481,33580,77667,54.857275290663985,43.235865940489525,1.9068587688464855,45.142724709336015
36,36113,11811,614,15200,27625,42.75475113122172,55.022624434389144,2.2226244343891404,57.24524886877828
36,36115,8537,493,14577,23607,36.163002499258695,61.74863387978142,2.088363620959885,63.836997500741305
36,36117,12799,892,23734,37425,34.19906479625919,63.41750167000668,2.3834335337341352,65.8009352037408
36,36119,220963,3773,126013,350749,62.99747112607591,35.9268308676575,1.0756980062665895,37.00252887392409
36,36121,5073,461,13897,19431,26.107765941022077,71.5197365035253,2.372497555452627,73.89223405897792
36,36123,4217,316,6208,10741,39.26077646401638,57.79722558421003,2.941997951773578,60.73922353598362
37,37001,38825,1210,46056,86091,45.09762925276742,53.496881207094816,1.4054895401377612,54.90237074723258
37,37003,4145,203,15888,20236,20.48329709428741,78.51354022534098,1.003162680371615,79.51670290571259
37,37005,1486,63,4527,6076,24.45687952600395,74.50625411454904,1.0368663594470047,75.54312047399605
37,37007,5789,84,5321,11194,51.71520457387886,47.53439342504913,0.7504020010720028,48.28479542612114
37,37009,4164,199,11451,15814,26.331099026179334,72.41052232199317,1.2583786518274946,73.66890097382067
37,37011,2191,95,7172,9458,23.165574117149504,75.82998519771623,1.0044406851342778,76.8344258828505
37,37013,9633,245,16437,26315,36.60649819494585,62.46247387421623,0.9310279308379252,63.39350180505415
37,37015,5939,59,3817,9815,60.509424350483954,38.88945491594498,0.6011207335710647,39.490575649516046
37,37017,7326,123,9676,17125,42.77956204379562,56.5021897810219,0.7182481751824817,57.22043795620438
37,37019,33310,1015,55850,90175,36.93928472414749,61.93512614360965,1.125589132242861,63.06071527585251
37,37021,96515,2642,62412,161569,59.73608798717576,38.62869733674158,1.6352146760826642,40.26391201282424
37,37023,13118,465,31019,44602,29.411237164252725,69.54620869019327,1.042554145554011,70.58876283574727
37,37025,52162,1828,63237,117227,44.49657502111288,53.9440572564341,1.5593677224530185,55.50342497888712
37,37027,10245,465,32119,42829,23.920707931541713,74.99357911695347,1.0857129515048214,76.07929206845829
37,37029,1537,104,4312,5953,25.81891483285738,72.43406685704686,1.74701831009575,74.18108516714261
37,37031,12093,574,30028,42695,28.324159737674197,70.33142054104697,1.3444197212788382,71.6758402623258
37,37033,4860,102,7089,12051,40.32860343539955,58.824993776450086,0.8464027881503611,59.67139656460045
37,37035,25689,1148,56588,83425,30.792927779442614,67.83098591549296,1.376086305064429,69.2070722205574
37,37037,26787,626,21186,48599,55.11841807444598,43.59348957797485,1.2880923475791684,44.88158192555402
37,37039,3583,212,12628,16423,21.81696401388297,76.8921634293369,1.2908725567801256,78.18303598611703
37,37041,3247,66,4471,7784,41.71377183967112,57.43833504624871,0.8478931140801645,58.28622816032888
37,37043,1699,82,5112,6893,24.648193819817205,74.16219352966777,1.1896126505150153,75.35180618018279
37,37045,16955,555,33798,51308,33.04552896234505,65.87276837920012,1.081702658454822,66.95447103765494
37,37047,9446,168,16832,26446,35.71806700446192,63.646676245935105,0.6352567496029645,64.28193299553809
37,37049,21148,885,31032,53065,39.853010458871196,58.47922359370583,1.6677659474229718,60.146989541128804
37,37051,84469,2649,60032,147150,57.40332993544003,40.7964661909616,1.800203873598369,42.59667006455997
37,37053,4195,295,11657,16147,25.980058215148325,72.19297702359572,1.8269647612559607,74.01994178485168
37,37055,9936,358,13938,24232,41.003631561571474,57.51898316275999,1.4773852756685375,58.996368438428526
37,37057,22636,1220,64658,88514,25.573355627358385,73.04833133741555,1.378313035226066,74.42664437264162
37,37059,6713,370,18228,25311,26.522065505116355,72.01611947374658,1.461815021137055,73.47793449488364
37,37061,8767,155,13793,22715,38.595641646489106,60.72198987453225,0.6823684789786485,61.404358353510894
37,37063,144688,2767,32459,179914,80.4206454194782,18.04139755661038,1.5379570239114242,19.579354580521795
37,37065,16089,182,9206,25477,63.15107744239903,36.13455273383836,0.7143698237626095,36.84892255760097
37,37067,113029,3173,85060,201262,56.16012958233546,42.26331846051416,1.5765519571503812,43.83987041766454
37,37069,15882,571,20904,37357,42.51412051288915,55.957384158256815,1.52849532885403,57.48587948711085
37,37071,40959,1506,73033,115498,35.46295173942406,63.233129578001346,1.30391868257459,64.53704826057594
37,37073,2546,58,3367,5971,42.6394238820968,56.38921453692849,0.9713615809747111,57.3605761179032
37,37075,905,50,3710,4665,19.39978563772776,79.52840300107181,1.0718113612004287,80.60021436227224
37,37077,14565,386,16647,31598,46.09468953731249,52.683714159123994,1.2215963035635167,53.90531046268751
37,37079,3832,47,4874,8753,43.77927567691077,55.68376556609162,0.5369587569976009,56.22072432308923
37,37081,173086,4106,107294,284486,60.84165828898435,37.71503694382149,1.4433047671941677,39.15834171101565
37,37083,15545,134,10080,25759,60.34783959004619,39.131953880197216,0.52020652975659,39.65216040995381
37,37085,22093,1023,35177,58293,37.89991937282349,60.345152934314584,1.7549276928619215,62.10008062717651
37,37087,13144,564,22834,36542,35.96956926276613,62.48700125882546,1.5434294784084068,64.03043073723387
37,37089,27211,1128,40032,68371,39.79903760366238,58.55114010326016,1.6498222930774746,60.20096239633762
37,37091,7097,58,3479,10634,66.73876246003385,32.71581719014482,0.5454203498213278,33.261237539966146
37,37093,11804,382,9453,21639,54.54965571421969,43.68501317066408,1.7653311151162254,45.45034428578031
37,37095,1046,28,1418,2492,41.974317817014445,56.90208667736758,1.1235955056179776,58.025682182985555
37,37097,33888,1473,67010,102371,33.10312490842133,65.45799103261666,1.4388840589620109,66.89687509157866
37,37099,9591,481,11356,21428,44.75919357849543,52.99607989546388,2.2447265260406946,55.24080642150457
37,37101,41261,1747,68354,111362,37.05123830390977,61.380003951078464,1.5687577450117636,62.94876169609023
37,37103,2197,48,3280,5525,39.76470588235294,59.366515837104075,0.8687782805429864,60.23529411764706
37,37105,12143,396,16469,29008,41.860865968008824,56.773993381136236,1.3651406508549366,58.139134031991176
37,37107,13605,214,14590,28409,47.88975324721039,51.35696434228589,0.7532824105037136,52.11024675278961
37,37109,13274,602,36341,50217,26.433279566680607,72.36792321325447,1.1987972200649182,73.56672043331939
37,37111,5832,288,16883,23003,25.353214798069818,73.3947745946181,1.2520106073120898,74.64678520193019
37,37113,6230,302,14211,20743,30.03422841440486,68.50985874752928,1.4559128380658535,69.96577158559514
37,37115,4901,196,7979,13076,37.48088100336494,61.02018966044662,1.4989293361884368,62.51911899663506
37,37117,5911,97,6532,12540,47.1371610845295,52.089314194577355,0.773524720893142,52.8628389154705
37,37119,378107,9735,179211,567053,66.67930510904625,31.603924148183683,1.716770742770076,33.320694890953746
37,37121,1867,84,7090,9041,20.65037053423294,78.42052870257716,0.9291007631899125,79.34962946576707
37,37123,4327,111,8411,12849,33.675772433652426,65.46034710872442,0.8638804576231612,66.32422756634757
37,37125,20779,796,36764,58339,35.61768285366564,63.017878263254424,1.3644388830799294,64.38231714633436
37,37127,25947,497,25827,52271,49.63937938818848,49.40980658491324,0.9508140268982801,50.36062061181152
37,37129,66146,2361,63333,131840,50.17141990291262,48.03777305825243,1.7908070388349513,49.82858009708738
37,37131,6069,51,3989,10109,60.03561183104165,39.4598872292017,0.5045009397566526,39.96438816895835
37,37133,24266,1891,46078,72235,33.59313352253063,63.78902194227175,2.617844535197619,66.40686647746938
37,37135,63594,1227,20176,84997,74.81911126275045,23.737308375589727,1.4435803616598233,25.180888737249546
37,37137,2713,69,4849,7631,35.552352247411875,63.543441226575816,0.9042065260123182,64.44764775258813
37,37139,9832,295,9770,19897,49.41448459566769,49.102879831130316,1.4826355732019902,50.58551540433231
37,37141,11723,490,21956,34169,34.30887646697299,64.25707512657672,1.4340484064502912,65.69112353302701
37,37143,2492,89,4903,7484,33.297701763762696,65.51309460181722,1.1892036344200962,66.70229823623731
37,37145,8465,245,13184,21894,38.6635607929113,60.21741116287568,1.1190280442130263,61.3364392070887
37,37147,47252,1339,38982,87573,53.95726993479726,44.51371998218629,1.529010083016455,46.04273006520274
37,37149,4518,151,7689,12358,36.559313804822786,62.21880563197928,1.2218805631979284,63.440686195177214
37,37151,15618,804,56894,73316,21.302307818211577,77.60106934366304,1.096622838125375,78.69769218178843
37,37153,8754,179,11830,20763,42.16153735009392,56.976352164908725,0.8621104849973511,57.83846264990608
37,37155,19020,362,27806,47188,40.306857675680256,58.925998135119094,0.7671441892006442,59.693142324319744
37,37157,15992,516,31301,47809,33.44976887196972,65.47093643456253,1.0792946934677572,66.55023112803028
37,37159,23114,997,49297,73408,31.487031386224935,67.15480601569311,1.358162598081953,68.51296861377506
37,37161,9135,403,24891,34429,26.532864736123617,72.29661041563797,1.1705248482384036,73.46713526387639
37,37163,10966,241,17411,28618,38.318540778530995,60.8393318890209,0.8421273324481097,61.681459221469005
37,37165,7186,116,7473,14775,48.636209813874785,50.57868020304569,0.7851099830795263,51.363790186125215
37,37167,8129,352,25458,33939,23.951795869059193,75.01104923539292,1.0371548955478946,76.0482041309408
37,37169,5286,273,20143,25702,20.566492879931523,78.37133297019687,1.0621741498716053,79.43350712006847
37,37171,8721,379,27538,36638,23.80315519406081,75.16239969430646,1.034445111632731,76.1968448059392
37,37173,2780,127,4161,7068,39.33220147142048,58.87096774193549,1.7968307866440294,60.66779852857952
37,37175,8444,324,11636,20404,41.3840423446383,57.028033718878646,1.5879239364830426,58.6159576553617
37,37177,758,15,1044,1817,41.71711612548156,57.45734727572922,0.8255365987892129,58.28288387451844
37,37179,48725,1904,80382,131011,37.191533535351994,61.35515338406699,1.45331308058102,62.808466464648006
37,37181,12431,177,8391,20999,59.19805705033573,39.95904566884138,0.8428972808228963,40.80194294966427
37,37183,393336,12297,226197,631830,62.25345425193486,35.80029438298277,1.9462513650823798,37.74654574806514
37,37185,6400,141,3752,10293,62.178179345186045,36.45195764111532,1.36986301369863,37.821820654813955
37,37187,3396,28,2781,6205,54.73005640612409,44.81869460112812,0.4512489927477841,45.26994359387591
37,37189,17122,647,14451,32220,53.14090626939789,44.85102420856611,2.0080695220360023,46.85909373060211
37,37191,24215,613,30709,55537,43.60156292201595,55.294668419252034,1.1037686587320164,56.39843707798405
37,37193,7510,363,27591,35464,21.17640424092037,77.80002255808708,1.0235732009925558,78.82359575907964
37,37195,20754,400,19581,40735,50.94881551491347,48.06922793666381,0.9819565484227324,49.05118448508653
37,37197,3763,227,15933,19923,18.887717713195805,79.97289564824574,1.1393866385584501,81.1122822868042
37,37199,3688,148,7516,11352,32.4876673713883,66.20859760394644,1.3037350246652573,67.5123326286117
38,38001,258,30,981,1269,20.33096926713948,77.30496453900709,2.3640661938534278,79.66903073286052
38,38003,1820,177,3568,5565,32.70440251572327,64.11500449236298,3.1805929919137466,67.29559748427673
38,38005,822,45,1094,1961,41.917389087200405,55.78786333503315,2.2947475777664454,58.082610912799595
38,38007,72,22,541,635,11.338582677165354,85.19685039370079,3.4645669291338583,88.66141732283465
38,38009,821,75,2575,3471,23.653125900316912,74.18611351195621,2.16076058772688,76.34687409968309
38,38011,228,34,1395,1657,13.759806879903442,84.18829209414605,2.051901025950513,86.24019312009656
38,38013,137,24,994,1155,11.861471861471863,86.06060606060606,2.0779220779220777,88.13852813852813
38,38015,14348,1661,34744,50753,28.27025003448072,68.45703702244202,3.2727129430772566,71.72974996551928
38,38017,40311,3123,42619,86053,46.844386598956454,49.52645462679976,3.62915877424378,53.155613401043546
38,38019,474,47,1499,2020,23.465346534653463,74.20792079207921,2.3267326732673266,76.53465346534654
38,38021,608,74,1742,2424,25.082508250825082,71.86468646864687,3.052805280528053,74.91749174917491
38,38023,265,33,904,1202,22.04658901830283,75.20798668885192,2.7454242928452577,77.95341098169717
38,38025,342,45,1951,2338,14.627887082976903,83.44739093242087,1.924721984602224,85.3721129170231
38,38027,383,24,854,1261,30.37272006344171,67.72402854877082,1.9032513877874702,69.6272799365583
38,38029,237,34,1738,2009,11.796913887506221,86.51070184171229,1.6923842707814833,88.20308611249378
38,38031,373,43,1362,1778,20.97862767154106,76.6029246344207,2.418447694038245,79.02137232845894
38,38033,137,18,871,1026,13.352826510721247,84.89278752436647,1.7543859649122806,86.64717348927876
38,38035,12880,1103,16987,30970,41.58863416209235,54.84985469809494,3.5615111398127217,58.41136583790765
38,38037,207,29,1145,1381,14.98913830557567,82.91093410572049,2.0999275887038378,85.01086169442434
38,38039,308,35,907,1250,24.64,72.56,2.8000000000000003,75.36
38,38041,196,25,1091,1312,14.939024390243901,83.15548780487805,1.9054878048780488,85.0609756097561
38,38043,221,24,1215,1460,15.136986301369863,83.21917808219177,1.643835616438356,84.86301369863014
38,38045,527,47,1645,2219,23.749436683190623,74.13249211356468,2.118071203244705,76.25056331680938
38,38047,128,18,930,1076,11.895910780669144,86.43122676579925,1.6728624535315983,88.10408921933086
38,38049,564,75,2364,3003,18.78121878121878,78.72127872127872,2.4975024975024978,81.21878121878122
38,38051,261,41,1153,1455,17.938144329896907,79.24398625429554,2.8178694158075603,82.06185567010309
38,38053,814,123,4482,5419,15.02122162760657,82.70898689795165,2.269791474441779,84.97877837239344
38,38055,1230,108,4198,5536,22.21820809248555,75.83092485549133,1.9508670520231215,77.78179190751445
38,38057,704,115,3856,4675,15.058823529411763,82.4812834224599,2.4598930481283423,84.94117647058823
38,38059,3872,504,12243,16619,23.29863409350743,73.66869246043684,3.0326734460557194,76.70136590649257
38,38061,1256,85,2824,4165,30.15606242496999,67.8031212484994,2.0408163265306123,69.84393757503001
38,38063,586,50,1141,1777,32.97692740574001,64.20934158694429,2.8137310073157007,67.02307259425999
38,38065,129,19,918,1066,12.101313320825517,86.11632270168855,1.7823639774859286,87.89868667917449
38,38067,786,85,2460,3331,23.596517562293606,73.85169618733113,2.5517862503752626,76.4034824377064
38,38069,497,46,1585,2128,23.355263157894736,74.48308270676691,2.161654135338346,76.64473684210526
38,38071,1639,156,3577,5372,30.51005212211467,66.58600148920327,2.9039463886820553,69.48994787788533
38,38073,945,91,1418,2454,38.50855745721272,57.783211083944586,3.7082314588427057,61.49144254278728
38,38075,220,34,1065,1319,16.67930250189538,80.74298711144806,2.577710386656558,83.32069749810462
38,38077,2510,230,5072,7812,32.13005632360471,64.92575524833589,2.944188428059396,67.86994367639528
38,38079,2482,65,1257,3804,65.24710830704522,33.04416403785489,1.7087276550998949,34.752891692954776
38,38081,738,66,1266,2070,35.65217391304348,61.15942028985507,3.1884057971014492,64.34782608695653
38,38083,104,20,688,812,12.807881773399016,84.72906403940887,2.4630541871921183,87.19211822660098
38,38085,804,124,258,1186,67.79089376053963,21.75379426644182,10.45531197301855,32.20910623946037
38,38087,44,3,380,427,10.304449648711945,88.99297423887587,0.702576112412178,89.69555035128806
38,38089,2499,441,12110,15050,16.6046511627907,80.46511627906978,2.9302325581395348,83.3953488372093
38,38091,392,44,652,1088,36.029411764705884,59.92647058823529,4.044117647058823,63.970588235294116
38,38093,2676,289,6994,9959,26.870167687518826,70.22793453157948,2.901897780901697,73.12983231248117
38,38095,317,27,830,1174,27.001703577512775,70.6984667802385,2.2998296422487225,72.99829642248723
38,38097,1493,121,2522,4136,36.09767891682785,60.976789168278536,2.925531914893617,63.90232108317215
38,38099,1333,126,3324,4783,27.869537946895257,69.49613213464353,2.6343299184612166,72.13046205310474
38,38101,7293,979,19974,28246,25.81958507399278,70.71443744246973,3.465977483537492,74.18041492600722
38,38103,442,39,1893,2374,18.618365627632688,79.73883740522325,1.6427969671440605,81.38163437236732
38,38105,2169,426,11739,14334,15.131854332356633,81.89619087484303,2.971954792800335,84.86814566764336
39,39001,2156,119,9870,12145,17.752161383285305,81.26801152737752,0.9798270893371758,82.24783861671469
39,39003,13611,699,32052,46362,29.35809499158794,69.13420473663776,1.5077002717742978,70.64190500841207
39,39005,6448,433,19002,25883,24.91210447011552,73.414982807248,1.6729127226364795,75.08789552988448
39,39007,16497,850,26890,44237,37.29231186563284,60.786219680358066,1.9214684540090874,62.70768813436716
39,39009,14772,486,10862,26120,56.55436447166922,41.584992343032155,1.8606431852986216,43.44563552833078
39,39011,4583,362,20451,25396,18.046148999842497,80.52842967396441,1.4254213261931012,81.9538510001575
39,39013,9007,435,23092,32534,27.684883506485527,70.9780537284072,1.3370627651072724,72.31511649351447
39,39015,4326,228,16032,20586,21.01428155056835,77.87816962984553,1.1075488195861265,78.98571844943166
39,39017,69613,2670,114392,186675,37.29101379402705,61.27869291549485,1.4302932904781038,62.70898620597295
39,39019,3206,226,10525,13957,22.970552410976573,75.4101884359103,1.6192591531131333,77.02944758902342
39,39021,4946,337,14086,19369,25.535649749599877,72.72445660591667,1.739893644483453,74.46435025040012
39,39023,24076,1243,39032,64351,37.4135600068375,60.654846078538014,1.9315939146244812,62.5864399931625
39,39025,34092,2048,74570,110710,30.793966218047153,67.35615572215698,1.849878059795863,69.20603378195284
39,39027,4556,323,15061,19940,22.848545636910732,75.53159478435306,1.6198595787362084,77.15145436308927
39,39029,13183,862,35124,49169,26.811608940592652,71.43525392015295,1.7531371392544082,73.18839105940735
39,39031,4057,309,11982,16348,24.816491313922192,73.29336921947639,1.890139466601419,75.1835086860778
39,39033,4831,348,15043,20222,23.88982296508753,74.38927900306597,1.7208980318465037,76.11017703491247
39,39035,416176,8285,202699,627160,66.35882390458575,32.32014159066267,1.3210345047515786,33.64117609541425
39,39037,4731,426,22003,27160,17.41899852724595,81.01251840942562,1.5684830633284241,82.58100147275405
39,39039,5870,384,12778,19032,30.842791088692728,67.13955443463641,2.01765447667087,69.157208911307265
39,39041,57735,2227,66356,126318,45.706075143684984,52.53091404233759,1.763010813977422,54.293924856315016
39,39043,17142,657,21724,39523,43.37221364774941,54.965463148040385,1.6623232042102067,56.62778635225059
39,39045,30634,1216,49714,81564,37.558236476877056,60.95090971507038,1.4908538080525722,62.441763523122944
39,39047,2911,174,9220,12305,23.657049979683055,74.9288906948395,1.4140593254774483,76.34295002031695
39,39049,409144,12151,211237,632532,64.68352589276117,33.39546457728621,1.9210095299526349,35.31647410723883
39,39051,6664,406,15731,22801,29.226788298758827,68.99258804438402,1.7806236568571554,70.77321170124117
39,39053,2911,158,10289,13358,21.79218445875131,77.02500374307532,1.1828117981733792,78.20781554124869
39,39055,20980,820,33581,55381,37.88302847546993,60.63631931528863,1.4806522092414365,62.11697152453007
39,39057,34798,1773,52072,88643,39.256342858432134,58.74349920467493,2.00015793689293,60.743657141567866
39,39059,4577,280,13407,18264,25.060227770477443,73.40670170827858,1.5330705212439772,74.93977222952256
39,39061,246266,6777,177886,430929,57.147697184454984,41.279653956916334,1.5726488586286835,42.852302815545016
39,39063,11535,668,25796,37999,30.356062001631624,67.88599699992105,1.7579409984473275,69.64393799836837
39,39065,3062,236,9949,13247,23.114667471880427,75.1037970861327,1.781535441986865,76.88533252811958
39,39067,1742,90,5668,7500,23.226666666666667,75.57333333333334,1.2,76.77333333333334
39,39069,3995,214,10273,14482,27.58596878884132,70.9363347603922,1.4776964507664687,72.41403121115869
39,39071,3741,193,15369,19303,19.380407190592138,79.6197482256644,0.9998445837434595,80.61959280940786
39,39073,3836,396,9554,13786,27.825330044973164,69.3021906281735,2.8724793268533295,72.17466995502684
39,39075,1994,188,10796,12978,15.364462937278473,83.18693173062105,1.4486053321004777,84.63553706272153
39,39077,7643,448,18537,26628,28.702869160282408,69.61469130238847,1.6824395373291272,71.2971308397176
39,39079,3193,163,10804,14160,22.54943502824859,76.29943502824858,1.1511299435028248,77.45056497175142
39,39081,10018,524,22828,33370,30.02097692538208,68.40875037458795,1.570272700029967,69.97902307461791
39,39083,8589,530,22340,31459,27.302202867224008,71.01306462379605,1.684732508979942,72.69779713277599
39,39085,54337,1915,71615,127867,42.49493614458773,56.00741395356113,1.4976499018511422,57.50506385541227
39,39087,7353,315,19759,27427,26.809348452255076,72.04214824807671,1.1485032996682103,73.19065154774492
39,39089,32324,1541,57965,91830,35.19982576500054,63.12207339649352,1.6781008385059348,64.80017423499946
39,39091,4990,370,17625,22985,21.709810746138785,76.68044376767456,1.6097454861866434,78.29018925386121
39,39093,72792,2477,76719,151988,47.89325473063663,50.47701134300077,1.6297339263626076,52.10674526936337
39,39095,111989,3265,79628,194882,57.46503012079104,40.85959708952084,1.675372789688119,42.53496987920896
39,39097,5558,306,13445,19309,28.78450463514423,69.63074214097054,1.5847532238852349,71.21549536485577
39,39099,56346,1618,58601,116565,48.33869514862952,50.273238107493675,1.388066743876807,51.66130485137048
39,39101,8089,511,18526,27126,29.820098798200988,68.296099682961,1.883801518838015,70.17990120179901
39,39103,39800,1643,64598,106041,37.532652464612745,60.917946831885786,1.5494007035014759,62.467347535387255
39,39105,2452,149,8163,10764,22.779635823114084,75.8361204013378,1.3842437755481234,77.22036417688591
39,39107,3981,300,19145,23426,16.993938359088194,81.72543327926236,1.2806283616494492,83.00606164091181
39,39109,15663,1043,41371,58077,26.96936825249238,71.23474008643697,1.7958916610706477,73.03063174750761
39,39111,1597,77,5392,7066,22.601188791395415,76.30908576280781,1.0897254457967733,77.39881120860458
39,39113,131592,4172,126085,261849,50.25491791070426,48.151797409957645,1.5932846793380917,49.74508208929574
39,39115,1725,90,5041,6856,25.16044340723454,73.52683780630105,1.3127187864644108,74.83955659276546
39,39117,3988,316,13784,18088,22.04776647501106,76.20521892967713,1.747014595311809,77.95223352498894
39,39119,11755,604,27334,39693,29.614793540422745,68.86352757413145,1.5216788854457965,70.38520645957726
39,39121,1156,41,5024,6221,18.582221507796174,80.75872046294808,0.6590580292557466,81.41777849220382
39,39123,8847,393,14285,23525,37.60680127523911,60.722635494155156,1.6705632306057385,62.39319872476089
39,39125,2172,181,6927,9280,23.405172413793103,74.64439655172413,1.9504310344827587,76.59482758620689
39,39127,4006,214,11959,16179,24.76049199579702,73.9168057358304,1.3227022683725818,75.23950800420297
39,39129,7304,417,20593,28314,25.796425796425797,72.73080454898637,1.4727696545878364,74.2035742035742
39,39131,3051,140,8872,12063,25.292215866699824,73.54721047832214,1.160573654978032,74.70778413330018
39,39133,35661,1371,45990,83022,42.95367492953675,55.39495555394956,1.651369516513695,57.04632507046325
39,39135,4435,305,16697,21437,20.688529178523112,77.8886971124691,1.4227737090077903,79.31147082147689
39,39137,3152,301,16218,19671,16.02358802297799,82.4462406588379,1.530171318184129,83.97641197702201
39,39139,17640,863,41472,59975,29.41225510629429,69.14881200500209,1.4389328887036266,70.58774489370572
39,39141,10345,499,21687,32531,31.80043650671667,66.66564200301252,1.5339214902708187,68.19956349328334
39,39143,10391,612,18487,29490,35.235673109528655,62.6890471346219,2.0752797558494405,64.76432689047135
39,39145,9080,362,22609,32051,28.329849302673864,70.54070075816668,1.1294499391594648,71.67015069732614
39,39147,8147,436,16739,25322,32.173603980728224,66.10457309849143,1.721822920780349,67.82639601927178
39,39149,4399,398,19988,24785,17.748638289287875,80.64555174500705,1.6058099657050635,82.25136171071213
39,39151,74336,2768,108610,185714,40.027138503290004,58.48239766522718,1.4904638314828178,59.972861496709996
39,39153,151668,4779,124833,281280,53.920648464163826,44.38033276450512,1.699018771331058,46.079351535836174
39,39155,43534,1387,53756,98677,44.11767686492293,54.476727099526734,1.4055960355503307,55.88232313507707
39,39157,12643,623,29519,42785,29.550075961201355,68.99380624050485,1.4561177982937945,70.44992403879864
39,39159,11141,725,21669,33535,33.222006858506035,64.61607275980319,2.161920381690771,66.77799314149397
39,39161,3026,271,11470,14767,20.491636757635266,77.6731902214397,1.8351730209250356,79.50836324236474
39,39163,1306,71,4525,5902,22.128092172145035,76.66892578786852,1.2029820399864453,77.87190782785497
39,39165,46069,2384,87988,136441,33.764777449593595,64.48794717130481,1.7472753791015896,66.2352225504064
39,39167,9114,470,21798,31382,29.04212605952457,69.46020011471545,1.4976738257599898,70.95787394047542
39,39169,16660,861,36759,54280,30.692704495210023,67.7210759027266,1.586219602063375,69.30729550478998
39,39171,4726,346,13218,18290,25.839256424275558,72.26899945325314,1.8917441224712956,74.16074357572444
39,39173,30617,1277,35757,67651,45.257276315205985,52.85509452927525,1.8876291555187652,54.742723684794015
39,39175,2690,184,8248,11122,24.18629742852005,74.15932386261463,1.6543787088653121,75.81370257147995
40,40001,1387,136,5585,7108,19.513224535734384,78.57343837929093,1.9133370849746762,80.48677546426562
40,40003,232,52,1978,2262,10.256410256410255,87.44473916887709,2.2988505747126435,89.74358974358975
40,40005,765,67,4557,5389,14.195583596214512,84.56114306921508,1.2432733345704212,85.8044164037855
40,40007,190,20,1968,2178,8.723599632690542,90.35812672176309,0.9182736455463728,91.27640036730946
40,40009,1048,133,6767,7948,13.18570709612481,85.14091595369905,1.673376950176145,86.81429290387518
40,40011,688,77,3136,3901,17.636503460651117,80.3896436811074,1.9738528582414765,82.36349653934889
40,40013,3323,309,12344,15976,20.799949924887333,77.26589884827241,1.9341512268402603,79.20005007511267
40,40015,2670,176,7013,9859,27.08185414342225,71.13297494674916,1.785170909828583,72.91814585657775
40,40017,16742,1648,43550,61940,27.029383274136258,70.30997739748143,2.6606393283823055,72.97061672586375
40,40019,4470,310,14699,19479,22.947789927614355,75.46075260536989,1.5914574670157606,77.05221007238565
40,40021,6027,464,11223,17714,34.02393586993339,63.35666704301682,2.619397087049791,65.97606413006662
40,40023,1082,52,4698,5832,18.55281207133059,80.55555555555556,0.8916323731138546,81.44718792866941
40,40025,70,14,970,1054,6.641366223908918,92.0303605313093,1.3282732447817838,93.35863377609108
40,40027,49827,3274,66677,119778,41.599458999148425,55.66715089582394,2.733390105027634,58.400541000851575
40,40029,374,59,2091,2524,14.817749603803488,82.8446909667195,2.3375594294770203,85.18225039619651
40,40031,13747,979,20905,35631,38.58157222643204,58.67082035306335,2.747607420504617,61.41842777356796
40,40033,393,62,2117,2572,15.279937791601867,82.3094867807154,2.410575427682737,84.72006220839813
40,40035,1217,129,4686,6032,20.175729442970823,77.68567639257294,2.1385941644562334,79.82427055702918
40,40037,6577,634,23294,30505,21.560399934436976,76.36125225372889,2.0783478118341256,78.43960006556303
40,40039,2369,262,8060,10691,22.158825180057992,75.39051538677393,2.4506594331680853,77.84117481994201
40,40041,3472,216,13557,17245,20.133371991881706,78.61409104088142,1.2525369672368802,79.8666280081183
40,40043,214,21,2124,2359,9.07164052564646,90.03815175922001,0.8902077151335311,90.92835947435354
40,40045,162,23,1688,1873,8.649225840896957,90.12279765082755,1.2279765082754939,91.35077415910304
40,40047,4919,541,16970,22430,21.93045028979046,75.65760142666072,2.411948283548819,78.06954971020954
40,40049,1865,179,8878,10922,17.075627174510164,81.28547885002747,1.6388939754623695,82.92437282548984
40,40051,4144,419,18538,23101,17.938617375871175,80.24760832864378,1.813774295485044,82.06138262412883
40,40053,280,30,1916,2226,12.578616352201259,86.07367475292004,1.3477088948787064,87.42138364779873
40,40055,328,40,1605,1973,16.624429802331477,81.34820070957932,2.0273694880892044,83.37557019766852
40,40057,177,9,747,933,18.971061093247588,80.06430868167203,0.964630225080386,81.02893890675242
40,40059,136,24,1327,1487,9.145931405514458,89.24008069939475,1.6139878950907869,90.85406859448554
40,40061,783,66,4165,5014,15.616274431591542,83.06741124850419,1.316314319904268,84.38372556840847
40,40063,919,63,3875,4857,18.921144739551163,79.78175828700844,1.2970969734403952,81.07885526044883
40,40065,1646,183,6392,8221,20.02189514657584,77.75209828488019,2.2260065685439727,79.97810485342416
40,40067,319,40,2026,2385,13.375262054507337,84.94758909853249,1.6771488469601679,86.62473794549267
40,40069,738,72,3441,4251,17.3606210303458,80.94565984474241,1.6937191249117856,82.6393789696542
40,40071,4040,375,12834,17249,23.421647631746765,74.40431329352425,2.1740390747289697,76.57835236825323
40,40073,854,90,5521,6465,13.209590100541377,85.39829853054911,1.3921113689095126,86.79040989945862
40,40075,699,55,2673,3427,20.39684855558798,77.99824919754887,1.6049022468631455,79.60315144441202
40,40077,762,50,3437,4249,17.9336314426924,80.88962108731467,1.1767474699929397,82.0663685573076
40,40079,3299,293,15213,18805,17.54320659399096,80.89869715501197,1.5580962509970753,82.45679340600904
40,40081,2609,266,12013,14888,17.524180548092424,80.68914562063408,1.7866738312735089,82.47581945190757
40,40083,5455,511,15608,21574,25.28506535644758,72.34634282006118,2.3685918234912395,74.71493464355243
40,40085,711,60,3305,4076,17.443572129538765,81.08439646712463,1.4720314033366046,82.55642787046123
40,40087,3582,359,15295,19236,18.621334996880847,79.51237263464338,1.8662923684757744,81.37866500311915
40,40089,1858,124,9485,11467,16.20301735414668,82.71561873201361,1.081363913839714,83.79698264585332
40,40091,2031,132,6172,8335,24.367126574685063,74.0491901619676,1.5836832633473303,75.63287342531494
40,40093,320,63,3084,3467,9.22988174214018,88.95298528987597,1.8171329679838477,90.77011825785982
40,40095,1100,73,4891,6064,18.139841688654354,80.65633245382587,1.2038258575197889,81.86015831134564
40,40097,3581,296,12749,16626,21.538554071935522,76.68110188860821,1.7803440394562733,78.46144592806448
40,40099,1156,126,4612,5894,19.61316593145572,78.24906684764167,2.137767220902613,80.38683406854429
40,40101,8027,528,16526,25081,32.00430604840317,65.89051473226746,2.105179219329373,67.99569395159682
40,40103,1003,114,3821,4938,20.311867152693395,77.379505872823,2.3086269744835968,79.6881328473066
40,40105,712,69,3610,4391,16.21498519699385,82.21361876565703,1.5713960373491234,83.78501480300615
40,40107,896,84,3058,4038,22.18920257553244,75.73055968301139,2.080237741456166,77.81079742446755
40,40109,141724,7966,145050,294740,48.0844133812852,49.21286557644025,2.702721042274547,51.9155866187148
40,40111,4357,288,9668,14313,30.440857961293926,67.54698525815692,2.012156780549151,69.55914203870607
40,40113,6002,415,14121,20538,29.223877690135357,68.75547765118317,2.020644658681469,70.77612230986465
40,40115,2686,207,8545,11438,23.48312642070292,74.70711662878125,1.8097569505158246,76.51687357929708
40,40117,1363,156,5267,6786,20.085470085470085,77.61567933981726,2.2988505747126435,79.91452991452991
40,40119,10904,926,17813,29643,36.78440103903114,60.091758593934486,3.1238403670343757,63.21559896096886
40,40121,3768,305,13851,17924,21.022093282749385,77.27627761660344,1.701629100647177,78.97790671725062
40,40123,4117,398,10805,15320,26.873368146214098,70.52872062663185,2.597911227154047,73.12663185378591
40,40125,7275,670,20240,28185,25.811601915912718,71.81124711726096,2.377150966826326,74.18839808408728
40,40127,668,55,4016,4739,14.095800801856932,84.74361679679258,1.1605824013504957,85.90419919814306
40,40129,168,37,1629,1834,9.16030534351145,88.82224645583425,2.0174482006543077,90.83969465648855
40,40131,9589,933,34031,44553,21.522680852018944,76.38318407290193,2.0941350750791194,78.47731914798106
40,40133,2150,176,6011,8337,25.788652992683218,72.1002758786134,2.1110711287033705,74.21134700731679
40,40135,3035,238,12113,15386,19.72572468477837,78.72741453269205,1.5468607825295724,80.27427531522163
40,40137,3154,343,15560,19057,16.550348953140578,81.64978747966627,1.7998635671931575,83.44965104685943
40,40139,894,122,4505,5521,16.192718710378553,81.59753667813801,2.209744611483427,83.80728128962144
40,40141,597,35,2076,2708,22.045790251107828,76.66174298375185,1.292466765140325,77.95420974889217
40,40143,108996,7108,150574,266678,40.87176295007462,56.46285032886102,2.6653867210643547,59.12823704992538
40,40145,8464,709,26165,35338,23.951553568396626,74.04210764615993,2.006338785443432,76.04844643160337
40,40147,5790,635,17076,23501,24.637249478745584,72.66073784094293,2.702012680311476,75.36275052125441
40,40149,598,93,4086,4777,12.518316935315053,85.5348545111995,1.946828553485451,87.48168306468494
40,40151,591,94,2993,3678,16.06851549755302,81.3757476889614,2.55573681348559,83.93148450244698
40,40153,1005,169,6611,7785,12.909441233140656,84.91971740526654,2.1708413615928066,87.09055876685935
41,41001,2332,230,7316,9878,23.608017817371937,74.06357562259566,2.3284065600323953,76.39198218262806
41,41003,35780,2086,14853,52719,67.8692691439519,28.17390314687304,3.95682770917506,32.1307308560481
41,41005,139015,6173,110476,255664,54.37410038175104,43.211402465736285,2.4144971525126726,45.62589961824896
41,41007,12896,628,10205,23729,54.347001559273465,43.00644780648152,2.6465506342450165,45.652998440726535
41,41009,13535,1204,16779,31518,42.94371470270956,53.23624595469255,3.8200393425978807,57.05628529729044
41,41011,14024,972,21488,36484,38.438767678982565,58.89705076197785,2.664181559039579,61.561232321017435
41,41013,3715,347,11103,15165,24.497197494230136,73.21463897131552,2.288163534454336,75.50280250576986
41,41015,6056,383,8481,14920,40.58981233243968,56.843163538873995,2.567024128686327,59.41018766756032
41,41017,64102,3447,54183,121732,52.65829855748694,44.510071304176385,2.8316301383366738,47.34170144251306
41,41019,18780,1814,42513,63107,29.758980778677486,67.3665362004215,2.8744830209010095,70.24101922132252
41,41021,324,20,834,1178,27.504244482173174,70.79796264855688,1.697792869269949,72.49575551782682
41,41023,928,121,3544,4593,20.20465926409754,77.16089701720009,2.6344437187023733,79.79534073590246
41,41025,894,112,3475,4481,19.950903816112476,77.54965409506806,2.49944208881946,80.04909618388753
41,41027,8671,365,3911,12947,66.97304394840504,30.207770139800726,2.819185911794238,33.026956051594965
41,41029,59442,3069,63814,126325,47.05481891945379,50.515733227785475,2.4294478527607364,52.94518108054621
41,41031,4306,316,7044,11666,36.91068061032059,60.38059317675296,2.708726212926453,63.08931938967941
41,41033,18430,1430,31732,51592,35.72259265002326,61.50565979221585,2.771747557760893,64.27740734997674
41,41035,10260,1023,25048,36331,28.240345710274973,68.94387712972393,2.815777160001101,71.75965428972503
41,41037,788,99,3449,4336,18.173431734317344,79.54335793357934,2.283210332103321,81.82656826568265
41,41039,133924,7517,80144,221585,60.439109145474646,36.16851321163436,3.3923776428909895,39.560890854525354
41,41041,17248,857,12336,30441,56.66042508458986,40.52429289445156,2.8152820209585756,43.33957491541014
41,41043,26512,2642,43486,72640,36.497797356828194,59.86508810572687,3.637114537444934,63.502202643171806
41,41045,3202,350,8101,11653,27.477902686003603,69.5185789067193,3.0035184072770957,72.5220973139964
41,41047,80138,5594,78424,164156,48.81819732449621,47.774068568922246,3.407734106581544,51.18180267550379
41,41049,1371,161,3586,5118,26.787807737397422,70.06643220007815,3.1457600625244235,73.21219226260257
41,41051,366129,13356,82583,462068,79.23703870425997,17.872477643983135,2.890483651756884,20.762961295740027
41,41053,22842,1636,23670,48148,47.44122289607045,49.16092049513999,3.397856608789566,52.55877710392955
41,41055,257,26,914,1197,21.4703425229741,76.35756056808688,2.172096908939014,78.52965747702589
41,41057,7956,463,8306,16725,47.5695067264574,49.66218236173393,2.76831091180867,52.4304932735426
41,41059,10499,1038,21002,32539,32.265896309044535,64.54408555886782,3.1900181320876486,67.73410369095546
41,41061,4227,388,10247,14862,28.441663302381915,68.94765172924237,2.610684968375723,71.55833669761809
41,41063,1625,120,3404,5149,31.559526121577004,66.10992425713731,2.3305496212856864,68.44047387842299
41,41065,6467,472,6965,13904,46.51179516685846,50.093498273878026,3.394706559263521,53.48820483314154
41,41067,209549,11304,98916,319769,65.53136795624341,30.933580178191132,3.535051865565455,34.468632043756585
41,41069,216,37,710,963,22.429906542056074,73.72793354101765,3.8421599169262723,77.57009345794393
41,41071,27123,2185,29500,58808,46.12127601686845,50.16324309617739,3.7154808869541562,53.87872398313155
42,42001,18254,814,37567,56635,32.23095259115388,66.3317736382096,1.4372737706365322,67.76904740884612
42,42003,429065,11104,282324,722493,59.38673454275681,39.076364753706955,1.5369007035362279,40.61326545724319
42,42005,8453,424,27479,36356,23.2506326328529,75.5831224557157,1.1662449114314006,76.7493673671471
42,42007,37747,1228,54108,93083,40.55198049052996,58.128766799523,1.3192527099470366,59.44801950947004
42,42009,4367,182,23025,27574,15.837383041996084,83.50257488938855,0.6600420686153623,84.16261695800392
42,42011,89530,2789,105941,198260,45.157873499445174,53.43538787450822,1.4067386260466055,54.842126500554826
42,42013,17636,653,45306,63595,27.731739916660114,71.24144979951254,1.0268102838273447,72.26826008333988
42,42015,8044,513,21586,30143,26.686129449623465,71.61198288159771,1.7018876687788211,73.31387055037654
42,42017,204511,4152,187274,395937,51.652409347951824,47.29893897261433,1.0486516794338494,48.347590652048176
42,42019,37379,1432,74279,113090,33.05243611283049,65.68131576620391,1.2662481209656027,66.94756388716951
42,42021,21752,759,48094,70605,30.808016429431344,68.11698888180725,1.0749946887614192,69.19198357056865
42,42023,634,29,1771,2434,26.047658175842237,72.7608874281019,1.191454396055875,73.95234182415777
42,42025,11083,429,21773,33285,33.297281057533425,65.4138500826198,1.2888688598467777,66.70271894246657
42,42027,40054,1065,36371,77490,51.68925022583559,46.9363788875984,1.3743708865660085,48.31074977416441
42,42029,181170,4786,127693,313649,57.76202060264818,40.71206986153312,1.5259095358187018,42.23797939735182
42,42031,4671,237,14550,19458,24.00555041628122,74.77644156645081,1.218008017267962,75.99444958371878
42,42033,9673,620,29203,39496,24.49108770508406,73.93913307676728,1.5697792181486734,75.50891229491594
42,42035,5501,221,11897,17619,31.221976275611556,67.52369600998922,1.2543277143992282,68.77802372438845
42,42037,10532,541,20098,31171,33.78781559783132,64.47659683680344,1.7355875653652435,66.21218440216867
42,42039,12610,513,28002,41125,30.66261398176292,68.08996960486323,1.2474164133738601,69.33738601823708
42,42041,62237,2138,77212,141587,43.956719190321145,54.53325517173187,1.5100256379469867,56.043280809678855
42,42043,78912,1977,66365,147254,53.589036630583884,45.068385239110654,1.3425781303054587,46.410963369416116
42,42045,206615,2981,118627,328223,62.94958001115095,36.142196006983056,0.9082239818659875,37.05041998884905
42,42047,4522,244,12140,16906,26.747900153791555,71.80882526913523,1.4432745770732285,73.25209984620844
42,42049,68336,1936,66912,137184,49.81338931653837,48.775367389783064,1.411243293678563,50.18661068346163
42,42051,19518,445,39978,59941,32.56201931899702,66.6955839909244,0.7423966900785773,67.43798068100298
42,42053,715,42,1864,2621,27.27966425028615,71.11789393361313,1.6024418161007248,72.72033574971385
42,42055,22468,1120,57308,80896,27.773931962025316,70.84157436708861,1.3844936708860758,72.22606803797468
42,42057,1085,69,6824,7978,13.599899724241665,85.53522186011531,0.8648784156430183,86.40010027575833
42,42059,4900,179,12556,17635,27.785653529912107,71.19931953501559,1.0150269350722994,72.21434647008789
42,42061,5448,286,17059,22793,23.902075198525864,74.84315359978942,1.2547712016847279,76.09792480147414
42,42063,12634,475,28087,41196,30.668026021943877,68.17894941256432,1.1530245654917952,69.33197397805613
42,42065,4527,337,17960,22824,19.834384858044164,78.68909919383105,1.476515948124781,80.16561514195584
42,42067,2253,141,9649,12043,18.70796313210994,80.12123225110022,1.1708046167898363,81.29203686789006
42,42069,61881,1084,52295,115260,53.68818323789692,45.37133437445775,0.9404823876453237,46.31181676210308
42,42071,115294,5289,159902,280485,41.10522844358878,57.009109221527,1.8856623348842183,58.89477155641122
42,42073,15978,501,29597,46076,34.677489365396305,64.23517666464103,1.0873339699626703,65.3225106346037
42,42075,23932,1195,46731,71858,33.30457290767903,65.03242506053606,1.663002031784909,66.69542709232097
42,42077,95889,2108,82287,180284,53.187748219475935,45.64298551174813,1.1692662687759312,46.812251780524065
42,42079,64873,1519,86929,153321,42.31188160786846,56.69738652891646,0.9907318632150848,57.68811839213154
42,42081,16971,821,41462,59254,28.641104398015322,69.9733351334931,1.3855604684915785,71.35889560198467
42,42083,5076,284,14067,19427,26.12858392958254,72.40953312400268,1.4618829464147836,73.87141607041747
42,42085,20984,905,36059,57948,36.21177607510182,62.226478912128115,1.5617450127700696,63.78822392489818
42,42087,4599,229,16663,21491,21.39965566981527,77.53478200176818,1.0655623284165465,78.60034433018473
42,42089,43884,1040,38642,83566,52.51418040830003,46.24129430629682,1.2445252854031543,47.48581959169997
42,42091,318041,5171,184698,507910,62.61758973046406,36.364316512768006,1.0180937567679313,37.38241026953594
42,42093,3768,202,5842,9812,38.40195678760701,59.539339584182635,2.058703628210355,61.59804321239299
42,42095,84847,2453,83732,171032,49.60884512839703,48.95692034239207,1.434234529210908,50.39115487160297
42,42097,12703,657,28975,42335,30.005905279319713,68.44218731546002,1.551907405220267,69.9940947206803
42,42099,5950,409,18293,24652,24.135972740548432,74.20493266266429,1.6590945967872788,75.864027259451575
42,42101,604175,4854,132870,741899,81.43628714959853,17.9094458949264,0.6542669554750714,18.563712850401473
42,42103,13052,323,19241,32616,40.017169487368164,58.99251900907531,0.9903115035565367,59.982830512631836
42,42105,1716,99,7216,9031,19.00121802679659,79.90255785627284,1.0962241169305724,80.9987819732034
42,42107,20425,997,48100,69522,29.3791893213659,69.18673225741492,1.4340784212191824,70.6208106786341
42,42109,4910,247,13983,19140,25.653082549634277,73.05642633228841,1.290491118077325,74.34691745036572
42,42111,8543,414,31105,40062,21.324447106984174,77.64215466027657,1.0333982327392541,78.67555289301583
42,42113,921,56,2622,3599,25.59044178938594,72.85357043623229,1.5559877743817727,74.40955821061405
42,42115,6084,362,14879,21325,28.52989449003517,69.77256740914419,1.697538100820633,71.47010550996484
42,42117,4959,379,15753,21091,23.51239865345408,74.69062633350718,1.796975013038737,76.48760134654592
42,42119,7475,284,12356,20115,37.16132239622173,61.42679592344022,1.411881680338056,62.83867760377827
42,42121,7585,374,18569,26528,28.59243063932449,69.99773823884198,1.4098311218335344,71.40756936067551
42,42123,5987,394,14020,20401,29.346600656830546,68.72212146463409,1.931277878535366,70.65339934316945
42,42125,44746,1300,71397,117443,38.10018477048441,60.792895276857706,1.1069199526578852,61.89981522951559
42,42127,9191,261,18637,28089,32.720993983409876,66.34981665420628,0.9291893623838513,67.27900601659013
42,42129,71099,2797,128596,202492,35.112004424866164,63.5067064377852,1.381289137348636,64.88799557513383
42,42131,4704,218,9936,14858,31.65971193969579,66.87306501547987,1.467223044824337,68.3402880603042
42,42133,88113,3624,146728,238465,36.95007653114713,61.5302035938188,1.5197198750340721,63.04992346885287
44,44001,18050,444,9745,28239,63.91869400474521,34.50901235879458,1.5722936364602147,36.08130599525479
44,44003,49112,1460,41999,92571,53.05333203703103,45.36950016743905,1.5771677955299175,46.94666796296897
44,44005,29485,693,15722,45900,64.23747276688452,34.25272331154684,1.5098039215686274,35.76252723311548
44,44007,164997,3763,102546,271306,60.815831570256464,37.79717367105777,1.3869947586857645,39.184168429743536
44,44009,44548,1220,29818,75586,58.93684015558437,39.44910433148996,1.6140555129256742,41.06315984441563
45,45001,4101,117,8215,12433,32.98479852006756,66.07415748411486,0.9410439958175822,67.01520147993244
45,45003,32275,1321,51589,85185,37.88812584375184,60.56113165463404,1.550742501614134,62.11187415624816
45,45005,2718,40,835,3593,75.64709156693571,23.239632618981354,1.113275814082939,24.352908433064286
45,45007,27169,1359,67565,96093,28.273651566711415,70.31209349276222,1.4142549405263651,71.72634843328859
45,45009,4010,55,2417,6482,61.86362233878433,37.28787411292811,0.8485035482875656,38.13637766121567
45,45011,4720,109,5492,10321,45.73200271291542,53.211898071892264,1.0560992151923263,54.26799728708458
45,45013,43419,1222,53194,97835,44.37982317166658,54.37113507435989,1.2490417539735268,55.62017682833342
45,45015,45223,1838,57397,104458,43.29299814279423,54.947442991441534,1.7595588657642307,56.70700185720577
45,45017,3905,81,4305,8291,47.09926426245326,51.9237727656495,0.976962971897238,52.90073573754674
45,45019,121485,4075,93297,218857,55.508848243373535,42.629205371543975,1.8619463850824969,44.491151756626465
45,45021,6983,244,18043,25270,27.633557578155916,71.4008705975465,0.965571824297586,72.36644242184408
45,45023,6941,156,8660,15757,44.05026337500793,54.95970045059339,0.9900361743986799,55.94973662499207
45,45025,7431,148,11297,18876,39.3674507310871,59.84848484848485,0.7840644204280567,60.6325492689129
45,45027,8250,122,8361,16733,49.303770991454016,49.967130819339026,0.7290981892069563,50.696229008545984
45,45029,8602,241,10440,19283,44.609241300627495,54.14095317118706,1.2498055281854483,55.390758699372505
45,45031,15220,365,16832,32417,46.950674029058824,51.92337353857543,1.125952432365734,53.049325970941176
45,45033,6436,83,6582,13101,49.126020914434015,50.24043966109457,0.6335394244714144,50.873979085565985
45,45035,33824,1541,41913,77278,43.76924868656021,54.23665208726934,1.9940992261704495,56.23075131343979
45,45037,4953,167,8184,13304,37.2294046903187,61.515333734215275,1.2552615754660252,62.7705953096813
45,45039,7382,129,4625,12136,60.827290705339486,38.109756097560975,1.0629531970995385,39.172709294660514
45,45041,31153,742,32615,64510,48.29173771508293,50.55805301503643,1.1502092698806385,51.70826228491707
45,45043,15822,359,20487,36668,43.14934002399913,55.87160466892113,0.9790553070797425,56.85065997600087
45,45045,103030,5104,150021,258155,39.91013151013926,58.11276171292441,1.9771067769363369,60.08986848986074
45,45047,12145,430,19431,32006,37.94601012310192,60.71049178279073,1.3434980941073549,62.05398987689808
45,45049,5323,76,3906,9305,57.205803331542185,41.97743148844707,0.8167651800107469,42.794196668457815
45,45051,59180,1743,118821,179744,32.924603881075306,66.10568363895318,0.969712479971515,67.07539611892469
45,45053,7185,131,7078,14394,49.91663192997082,49.17326663887731,0.9101014311518688,50.08336807002918
45,45055,12699,459,20471,33629,37.76205061107972,60.87305599333909,1.3648933955811948,62.23794938892028
45,45057,18937,619,30312,49868,37.974252025346914,60.784471003449106,1.2412769712039786,62.025747974653086
45,45059,10159,325,20004,30488,33.32130674363684,65.6127000787195,1.065993177643663,66.67869325636316
45,45061,5329,94,3008,8431,63.207211481437554,35.677855533151465,1.1149329854109833,36.792788518562446
45,45063,49301,2450,92817,144568,34.10229096342206,64.20300481434342,1.6947042222345194,65.89770903657794
45,45065,2687,52,2958,5697,47.16517465332631,51.922064244339126,0.9127611023345621,52.83482534667369
45,45067,8872,121,5711,14704,60.337323177366706,38.83977149075082,0.822905331882481,39.662676822633294
45,45069,6290,112,5044,11446,54.953695614188355,44.06779661016949,0.9785077756421459,45.046304385811645
45,45071,6958,230,11443,18631,37.346358220170686,61.4191401427728,1.2345016370565187,62.653641779829314
45,45073,10414,556,29698,40668,25.60735713583161,73.0254745746041,1.3671682895642765,74.3926428641684
45,45075,27295,307,13603,41205,66.24196092707196,33.012983861181894,0.7450552117461473,33.75803907292804
45,45077,13645,994,42907,57546,23.711465610120598,74.5612205887464,1.7273138011330065,76.2885343898794
45,45079,132570,2939,58313,193822,68.39780829833558,30.08585196726894,1.5163397343954763,31.602191701664424
45,45081,2963,101,6210,9274,31.949536338149663,66.96139745525123,1.0890662065990941,68.05046366185033
45,45083,52926,2169,93560,148655,35.60324240691534,62.93767448118126,1.4590831119034005,64.39675759308466
45,45085,27379,541,21000,48920,55.96688470973017,42.927228127555196,1.1058871627146363,44.03311529026983
45,45087,4935,139,8183,13257,37.22561665535189,61.72588066681753,1.0485026778305802,62.77438334464811
45,45089,10289,164,5532,15985,64.36659368157648,34.60744447919925,1.0259618392242729,35.633406318423525
45,45091,59008,2315,82727,144050,40.963554321416176,57.42936480388754,1.607080874696286,59.036445678583824
46,46003,317,36,1052,1405,22.562277580071175,74.87544483985765,2.5622775800711746,77.43772241992883
46,46005,2107,166,4808,7081,29.755684225391892,67.90001412229911,2.344301652308996,70.24431577460811
46,46007,466,23,694,1183,39.391377852916314,58.66441251056636,1.944209636517329,60.608622147083686
46,46009,721,45,2235,3001,24.025324891702766,74.4751749416861,1.4995001666111296,75.97467510829723
46,46011,6110,457,8000,14567,41.944120271847325,54.91865174709961,3.137227981053065,58.055879728152675
46,46013,6538,429,10580,17547,37.25993047244543,60.29520715791873,2.4448623696358354,62.74006952755457
46,46015,673,67,1750,2490,27.028112449799195,70.28112449799197,2.6907630522088355,72.9718875502008
46,46017,352,14,183,549,64.11657559198542,33.33333333333333,2.5500910746812386,35.88342440801458
46,46019,939,132,3731,4802,19.55435235318617,77.69679300291546,2.7488546438983756,80.44564764681382
46,46021,117,9,747,873,13.402061855670103,85.56701030927834,1.0309278350515463,86.5979381443299
46,46023,1177,54,2552,3783,31.112873380914618,67.45968807824478,1.4274385408406027,68.88712661908538
46,46025,437,40,1373,1850,23.62162162162162,74.21621621621621,2.1621621621621623,76.37837837837839
46,46027,3083,159,2456,5698,54.10670410670411,43.1028431028431,2.7904527904527905,45.89329589329589
46,46029,3837,366,8958,13161,29.154319580578985,68.06473672213357,2.7809436972874404,70.84568041942102
46,46031,622,14,647,1283,48.480124707716286,50.42868277474669,1.0911925175370227,51.519875292283714
46,46033,1522,120,3852,5494,27.702948671277756,70.11285038223517,2.184200946487077,72.29705132872225
46,46035,2648,193,5613,8454,31.32245091081145,66.3946061036196,2.2829429855689614,68.67754908918855
46,46037,1052,43,1869,2964,35.49257759784076,63.056680161943326,1.4507422402159245,64.50742240215925
46,46039,609,42,1699,2350,25.914893617021278,72.29787234042553,1.7872340425531916,74.08510638297872
46,46041,1131,45,790,1966,57.527975584944045,40.18311291963377,2.2889114954221768,42.472024415055955
46,46043,216,23,1468,1707,12.65377855887522,85.99882835383714,1.3473930872876392,87.34622144112478
46,46045,417,30,1538,1985,21.007556675062972,77.48110831234257,1.5113350125944585,78.99244332493703
46,46047,1053,111,2878,4042,26.051459673428994,71.20237506185056,2.7461652647204358,73.948540326571
46,46049,198,20,964,1182,16.751269035532996,81.55668358714044,1.6920473773265652,83.248730964467
46,46051,1056,71,2618,3745,28.197596795727637,69.90654205607477,1.8958611481975967,71.80240320427237
46,46053,455,32,1771,2258,20.150575730735167,78.43224092116917,1.41718334809566,79.84942426926483
46,46055,105,6,1026,1137,9.234828496042216,90.23746701846966,0.5277044854881267,90.76517150395779
46,46057,647,64,2372,3083,20.986052546221213,76.93804735647097,2.0759000973078168,79.01394745377878
46,46059,373,30,1433,1836,20.315904139433552,78.05010893246187,1.6339869281045754,79.68409586056644
46,46061,557,38,1793,2388,23.3249581239531,75.08375209380235,1.5912897822445562,76.6750418760469
46,46063,49,16,748,813,6.027060270602706,92.00492004920049,1.968019680196802,93.9729397293973
46,46065,2953,248,5522,8723,33.85303221368795,63.30390920554855,2.8430585807634987,66.14696778631205
46,46067,762,61,2944,3767,20.228298380674275,78.1523758959384,1.6193257233873108,79.77170161932573
46,46069,136,10,564,710,19.154929577464788,79.43661971830987,1.4084507042253522,80.84507042253522
46,46071,359,18,738,1115,32.19730941704036,66.18834080717488,1.6143497757847534,67.80269058295964
46,46073,270,15,721,1006,26.838966202783297,71.66998011928429,1.4910536779324055,73.1610337972167
46,46075,90,11,498,599,15.025041736227045,83.13856427378965,1.8363939899833055,84.97495826377295
46,46077,819,56,1904,2779,29.47103274559194,68.51385390428212,2.0151133501259446,70.52896725440806
46,46079,2068,124,3681,5873,35.21198705942449,62.67665588285374,2.1113570577217775,64.78801294057551
46,46081,4537,538,8753,13828,32.810240092565806,63.299103268730114,3.8906566387040784,67.1897599074342
46,46083,11981,798,19617,32396,36.982960859365356,60.553772070625996,2.4632670700086434,63.017039140634644
46,46085,525,30,1042,1597,32.87413901064496,65.24733876017534,1.878522229179712,67.12586098935503
46,46087,769,63,2068,2900,26.517241379310345,71.3103448275862,2.1724137931034484,73.48275862068965
46,46089,222,27,1075,1324,16.76737160120846,81.19335347432025,2.0392749244712993,83.23262839879155
46,46091,858,33,1287,2178,39.39393939393939,59.09090909090909,1.5151515151515151,60.60606060606061
46,46093,3285,510,9875,13670,24.03072421360644,72.23847841989759,3.730797366495977,75.96927578639355
46,46095,298,22,449,769,38.751625487646294,58.38751625487646,2.860858257477243,61.248374512353706
46,46097,320,31,787,1138,28.119507908611602,69.15641476274165,2.724077328646749,71.88049209138839
46,46099,40482,2595,49249,92326,43.846803717262745,53.34250373675887,2.810692545978381,56.153196282737255
46,46101,1179,76,1951,3206,36.7747972551466,60.85464753587024,2.3705552089831565,63.2252027448534
46,46102,2829,74,297,3200,88.40625,9.28125,2.3125,11.59375
46,46103,20606,1849,35063,57518,35.825306860461076,60.960047289544136,3.2146458499947843,64.17469313953893
46,46105,239,29,1401,1669,14.319952067106051,83.94248052726184,1.7375674056321149,85.68004793289396
46,46107,227,14,1139,1380,16.44927536231884,82.53623188405797,1.0144927536231882,83.55072463768116
46,46109,1828,75,2404,4307,42.4425354074762,55.81611330392384,1.7413512885999536,57.5574645925238
46,46111,257,23,905,1185,21.68776371308017,76.37130801687763,1.9409282700421944,78.31223628691983
46,46115,998,61,2104,3163,31.552323743281697,66.51912741068607,1.9285488460322477,68.4476762567183
46,46117,421,28,1203,1652,25.484261501210653,72.82082324455206,1.694915254237288,74.51573849878935
46,46119,185,19,726,930,19.892473118279568,78.06451612903226,2.043010752688172,80.10752688172043
46,46121,1963,44,532,2539,77.3139031114612,20.953131153997635,1.732965734541158,22.6860968885388
46,46123,495,40,2161,2696,18.36053412462908,80.15578635014838,1.483679525222552,81.63946587537092
46,46125,1139,119,3290,4548,25.043975373790676,72.33948988566404,2.6165347405452946,74.95602462620933
46,46127,2725,186,5944,8855,30.77357425183512,67.12591756070016,2.100508187464709,69.22642574816487
46,46129,565,49,1966,2580,21.899224806201552,76.2015503875969,1.8992248062015504,78.10077519379846
46,46135,4016,303,6581,10900,36.84403669724771,60.37614678899082,2.779816513761468,63.15596330275229
46,46137,481,21,404,906,53.09050772626932,44.5916114790287,2.3178807947019866,46.90949227373068
47,47001,11733,631,23163,35527,33.02558617389591,65.19829988459482,1.7761139415092746,66.9744138261041
47,47003,4443,279,14317,19039,23.33630968013026,75.19827722044225,1.465413099427491,76.66369031986974
47,47005,1526,63,5661,7250,21.048275862068966,78.08275862068965,0.8689655172413793,78.95172413793104
47,47007,971,62,4725,5758,16.863494268843347,82.05974296630775,1.076762764848906,83.13650573115666
47,47009,17834,1277,47195,66306,26.896510119747834,71.17757065725576,1.9259192229964104,73.10348988025217
47,47011,9849,925,35194,45968,21.425774451792552,76.5619561434041,2.0122694048033414,78.57422554820745
47,47013,2438,161,12330,14929,16.330631656507467,82.59093040391184,1.078437939580682,83.66936834349254
47,47015,1261,111,5190,6562,19.216702224931424,79.09174032307223,1.6915574519963426,80.78329777506858
47,47017,2558,141,9194,11893,21.50845034894476,77.30597830656689,1.1855713444883544,78.49154965105524
47,47019,4613,382,19873,24868,18.549943702750525,79.91394563294193,1.5361106643075437,81.45005629724947
47,47021,5457,306,14328,20091,27.161415559205615,71.31551440943707,1.5230700313573242,72.83858444079439
47,47023,1411,216,5951,7578,18.619688572182632,78.52995513328055,2.8503562945368173,81.38031142781736
47,47025,2201,136,10598,12935,17.015848473134906,81.93274062620797,1.051410900657132,82.98415152686509
47,47027,735,38,2733,3506,20.96406160867085,77.95208214489446,1.0838562464346835,79.03593839132915
47,47029,2524,164,12182,14870,16.973772696704774,81.92333557498318,1.1028917283120376,83.02622730329523
47,47031,5704,746,17863,24313,23.460700037017233,73.47098260190022,3.0683173610825487,76.53929996298277
47,47033,1382,59,4673,6114,22.60385999345764,76.4311416421328,0.9649983644095519,77.39614000654237
47,47035,6728,412,25167,32307,20.82520815922246,77.89952641842325,1.2752654223542885,79.17479184077754
47,47037,197846,11064,99415,308325,64.16800454066326,32.24357415065272,3.5884213086840187,35.83199545933674
47,47039,904,117,4229,5250,17.21904761904762,80.55238095238096,2.2285714285714286,82.78095238095239
47,47041,1747,91,6663,8501,20.550523467827315,78.37901423361957,1.0704622985531114,79.44947653217268
47,47043,6098,625,17619,24342,25.051351573412212,72.38106975597732,2.5675786706104673,74.9486484265878
47,47045,3157,151,11766,15074,20.943346158949183,78.05492901685021,1.0017248242006105,79.05665384105082
47,47047,7000,267,15661,22928,30.530355896720167,68.30512909979065,1.1645150034891836,69.46964410327983
47,47049,1210,74,7403,8687,13.928859214918846,85.21929319673075,0.8518475883504086,86.07114078508116
47,47051,4863,306,13977,19146,25.399561266060793,73.00219366969603,1.598245064243184,74.6004387339392
47,47053,5764,327,16245,22336,25.805873925501434,72.73012177650429,1.4640042979942693,74.19412607449857
47,47055,3298,121,9783,13202,24.981063475231025,74.10240872595061,0.9165277988183609,75.018936524768975
47,47057,1463,101,8559,10123,14.452237479008199,84.55003457473082,0.9977279462609898,85.5477625209918
47,47059,5183,689,22185,28057,18.473108315215452,79.07117653348541,2.455715151299141,81.52689168478454
47,47061,985,64,4795,5844,16.854893908281998,82.04996577686516,1.0951403148528405,83.145106091718
47,47063,5497,320,18789,24606,22.34007965536861,76.3594245306023,1.3004958140290985,77.65992034463139
47,47065,75360,3384,91991,170735,44.138577327437254,53.87940375435617,1.9820189182065775,55.861422672562746
47,47067,362,10,2372,2744,13.192419825072887,86.44314868804665,0.36443148688046645,86.80758017492711
47,47069,4180,118,5760,10058,41.558958043348575,57.267846490355936,1.1731954662954862,58.441041956651425
47,47071,1774,204,9556,11534,15.380613837350444,82.85070227154499,1.7686838911045604,84.61938616264956
47,47073,4069,335,20372,24776,16.423151436874395,82.22473361317404,1.3521149499515661,83.57684856312561
47,47075,4000,82,3338,7420,53.908355795148246,44.98652291105121,1.1051212938005393,46.091644204851754
47,47077,2092,131,9797,12020,17.40432612312812,81.50582362728785,1.0898502495840265,82.595673876871885
47,47079,3547,257,11230,15034,23.593188772116534,74.69735266728749,1.7094585605959822,76.40681122788347
47,47081,2130,125,7577,9832,21.663954434499594,77.0646867371847,1.271358828315704,78.3360455655004
47,47083,869,97,2715,3681,23.607715294756858,73.75713121434393,2.6351534908992122,76.39228470524314
47,47085,2017,99,6116,8232,24.501943634596696,74.29543245869776,1.2026239067055393,75.4980563654033
47,47087,1133,69,4106,5308,21.34513941220799,77.35493594574227,1.2999246420497361,78.65486058779202
47,47089,4645,308,18609,23562,19.71394618453442,78.97886427298192,1.3071895424836601,80.28605381546558
47,47091,1242,85,6466,7793,15.937379699730528,82.9718978570512,1.090722443218273,84.06262030026947
47,47093,91097,4433,124339,219869,41.43239838267332,56.5514010615412,2.0162005557854905,58.56760161732668
47,47095,526,16,1492,2034,25.860373647984268,73.35299901671584,0.7866273352999017,74.13962635201574
47,47097,3193,98,5672,8963,35.62423295771505,63.28238313064822,1.0933839116367288,64.37576704228495
47,47099,3195,189,15334,18718,17.069131317448445,81.9211454215194,1.0097232610321616,82.93086868255156
47,47101,1068,63,4473,5604,19.05781584582441,79.81798715203426,1.1241970021413277,80.94218415417559
47,47103,2909,408,12258,15575,18.67736757624398,78.70304975922954,2.619582664526485,81.32263242375602
47,47105,6933,758,21684,29375,23.601702127659575,73.81787234042552,2.5804255319148934,76.39829787234042
47,47107,4357,283,18175,22815,19.097085250931407,79.6625027394258,1.2404120096427789,80.9029147490686
47,47109,1943,239,9085,11267,17.24505192154078,80.63370906186208,2.121239016597142,82.75494807845922
47,47111,1307,84,8095,9486,13.778199451823742,85.33628505165507,0.8855154965211892,86.22180054817626
47,47113,18309,616,23922,42847,42.73111303008378,55.8312133871683,1.437673582747917,57.26888696991622
47,47115,3165,166,9873,13204,23.970009088155106,74.77279612238715,1.25719478945774,76.02999091184489
47,47117,3603,230,11029,14862,24.243035930561163,74.20939308303055,1.5475709864082896,75.75696406943884
47,47119,14386,767,31408,46561,30.897102725456925,67.4555958849681,1.647301389574966,69.10289727454307
47,47121,1008,57,4464,5529,18.231144872490503,80.73792729245794,1.0309278350515463,81.7688551275095
47,47123,3760,247,16742,20749,18.121355246035954,80.68822593859946,1.1904188153645958,81.87864475396404
47,47125,32426,2096,42156,76678,42.28853126059626,54.97795977985863,2.733508959545111,57.71146873940374
47,47127,573,78,2888,3539,16.191014410850524,81.60497315625884,2.204012432890647,83.80898558914947
47,47129,1161,131,6926,8218,14.12752494524215,84.27841323923096,1.5940618155268922,85.87247505475784
47,47131,2589,142,10790,13521,19.147992012425117,79.80178980844612,1.0502181791287626,80.85200798757488
47,47133,2028,86,7911,10025,20.22942643391521,78.91271820448877,0.85785536159601,79.77057356608479
47,47135,615,38,2775,3428,17.94049008168028,80.95099183197199,1.1085180863477246,82.05950991831972
47,47137,524,25,2373,2922,17.932922655715263,81.21149897330595,0.8555783709787816,82.06707734428474
47,47139,1492,76,6792,8360,17.846889952153113,81.24401913875599,0.9090909090909091,82.1531100478469
47,47141,9154,633,23694,33481,27.340879902033986,70.7684955646486,1.8906245333174039,72.65912009796601
47,47143,2363,214,11031,13608,17.364785420340976,81.0626102292769,1.572604350382128,82.63521457965902
47,47145,6034,685,19195,25914,23.28471096704484,74.0719302307633,2.6433588021918655,76.71528903295516
47,47147,8690,487,24535,33712,25.77717133364974,72.7782392026578,1.4445894636924537,74.22282866635027
47,47149,59189,3369,81373,143931,41.12317707790539,56.536118000986576,2.340704921108031,58.87682292209461
47,47151,986,62,8004,9052,10.892620415377817,88.42244807777287,0.684931506849315,89.10737958462218
47,47153,1295,98,5846,7239,17.889211217018925,80.75701063682828,1.3537781461527836,82.11078878298107
47,47155,8695,1137,33742,43574,19.95456005875063,77.43608573920227,2.6093542020470926,80.04543994124937
47,47157,245208,7107,129543,381858,64.21444620775262,33.92439074210832,1.8611630501390568,35.785553792247384
47,47159,1798,113,7124,9035,19.90038738240177,78.84892086330936,1.2506917542888767,80.09961261759823
47,47161,1230,111,4942,6283,19.576635365271365,78.65669266274072,1.7666719719879038,80.42336463472864
47,47163,17226,1206,55774,74206,23.213756300029647,75.16103819098187,1.6252055089884914,76.78624369997036
47,47165,27630,1495,63404,92529,29.86090847193853,68.52338185866053,1.6157096694009447,70.13909152806147
47,47167,6832,396,20063,27291,25.033893957714998,73.51507823091862,1.4510278113663846,74.966106042285
47,47169,1011,50,2930,3991,25.331996993234778,73.41518416436983,1.2528188423953894,74.66800300676522
47,47171,1610,91,6593,8294,19.41162285989872,79.4911984567157,1.09717868338558,80.58837714010127
47,47173,1248,71,6777,8096,15.41501976284585,83.70800395256917,0.8769762845849802,84.58498023715416
47,47175,544,35,2338,2917,18.649297223174493,80.15083990401098,1.1998628728145355,81.3507027768255
47,47177,4126,243,12323,16692,24.718427989456025,73.82578480709321,1.4557872034507549,75.28157201054398
47,47179,18214,1096,40120,59430,30.647820965842165,67.50799259633182,1.8441864378260138,69.35217903415784
47,47181,820,52,5795,6667,12.299385030748462,86.92065396730163,0.7799610019499025,87.70061496925153
47,47183,3011,317,10382,13710,21.962071480671046,75.72574762946755,2.312180889861415,78.03792851932896
47,47185,2134,146,9587,11867,17.98264093705233,80.78705654335553,1.2303025195921464,82.01735906294766
47,47187,50161,2302,86469,138932,36.10471309705468,62.238361212679585,1.6569256902657414,63.89528690294532
47,47189,22197,1746,50149,74092,29.958699994601307,67.68477028559089,2.356529719807807,70.0413000053987
48,48001,3934,159,15062,19155,20.537718611328636,78.6322109109893,0.8300704776820673,79.46228138867136
48,48003,849,70,4937,5856,14.49795081967213,84.30669398907104,1.1953551912568305,85.50204918032787
48,48005,9136,422,25070,34628,26.383273651380385,72.39805937391705,1.218666974702553,73.61672634861961
48,48007,2896,135,9210,12241,23.658197859651988,75.23895106608937,1.102851074258639,76.34180214034801
48,48009,446,50,4300,4796,9.299416180150125,89.6580483736447,1.0425354462051708,90.70058381984987
48,48011,75,2,1035,1112,6.744604316546762,93.07553956834532,0.1798561151079137,93.25539568345324
48,48013,5865,200,12020,18085,32.43019076582803,66.46392037600222,1.1058888581697541,67.56980923417197
48,48015,2931,155,11282,14368,20.399498886414253,78.521714922049,1.0787861915367483,79.60050111358575
48,48017,407,17,1430,1854,21.952535059331176,77.13052858683926,0.9169363538295576,78.04746494066882
48,48019,2503,150,10050,12703,19.704006927497442,79.11516964496576,1.1808234275368024,80.29599307250255
48,48021,15452,771,20486,36709,42.09321964640824,55.80647797542837,2.100302378163393,57.90678035359176
48,48023,179,23,1478,1680,10.654761904761905,87.97619047619048,1.369047619047619,89.3452380952381
48,48025,3280,126,5999,9405,34.87506645401382,63.78522062732589,1.3397129186602872,65.12493354598618
48,48027,56032,2722,67113,125867,44.51683125839179,53.32056853662993,2.1626002049782707,55.48316874160821
48,48029,440823,11327,303871,756021,58.30830095989397,40.1934602345702,1.4982388055358251,41.69169904010603
48,48031,1905,85,5429,7419,25.67731500202183,73.176978029384,1.14570696859415,74.32268499797817
48,48033,16,1,395,412,3.8834951456310676,95.87378640776699,0.24271844660194172,96.11650485436893
48,48035,1552,96,7446,9094,17.06619749285243,81.87816142511547,1.0556410820321092,82.93380250714756
48,48037,10692,449,27053,38194,27.99392574749961,70.83049693669162,1.175577315808766,72.00607425250038
48,48039,61780,2318,89939,154037,40.107246960145936,58.387919785506085,1.5048332543479812,59.892753039854064
48,48041,35242,2055,47456,84753,41.58200889644024,55.99329817233608,2.424692931223673,58.41799110355976
48,48043,2251,103,2451,4805,46.84703433922997,51.009365244536944,2.1436004162330904,53.15296566077003
48,48045,77,8,639,724,10.6353591160221,88.25966850828729,1.1049723756906076,89.3646408839779
48,48047,1470,16,998,2484,59.17874396135265,40.17713365539453,0.644122383252818,40.82125603864735
48,48049,2103,156,13681,15940,13.193224592220828,85.82810539523213,0.9786700125470514,86.80677540777917
48,48051,1786,78,6740,8604,20.757787075778708,78.33565783356579,0.906555090655509,79.24221292422129
48,48053,5615,310,18721,24646,22.78260163921123,75.95958776272012,1.257810598068652,77.21739836078876
48,48055,6536,264,7975,14775,44.236886632825716,53.97631133671743,1.7868020304568528,55.763113367174284
48,48057,2146,67,5640,7853,27.32713612632115,71.81968674391952,0.8531771297593277,72.67286387367885
48,48059,734,86,6006,6826,10.753003222970992,87.98710811602696,1.259888661002051,89.24699677702901
48,48061,63732,1223,48834,113789,56.008928806826674,42.91627485960857,1.0747963335647557,43.991071193173326
48,48063,1392,39,3626,5057,27.52620130512161,71.7025904686573,0.7712082262210797,72.47379869487838
48,48065,289,45,2747,3081,9.380071405387861,89.15936384290815,1.4605647517039921,90.61992859461213
48,48067,2777,100,10979,13856,20.04185912240185,79.23643187066975,0.7217090069284064,79.95814087759815
48,48069,466,15,1601,2082,22.382324687800192,76.89721421709893,0.7204610951008645,77.61767531219981
48,48071,3997,301,17343,21641,18.469571646411904,80.1395499283767,1.3908784252114044,81.53042835358809
48,48073,4196,196,15065,19457,21.56550341779308,77.42714704219561,1.0073495400113068,78.43449658220692
48,48075,305,26,1928,2259,13.501549358123063,85.34749889331562,1.1509517485613103,86.49845064187694
48,48077,614,58,5064,5736,10.704323570432358,88.28451882845188,1.0111576011157601,89.29567642956764
48,48079,176,14,806,996,17.670682730923694,80.92369477911646,1.4056224899598393,82.32931726907631
48,48081,215,14,1565,1794,11.984392419175027,87.23522853957637,0.7803790412486065,88.01560758082498
48,48083,451,37,3640,4128,10.925387596899224,88.17829457364341,0.8963178294573644,89.07461240310077
48,48085,230945,8953,252318,492216,46.919441871048484,51.26164123067921,1.8189168982723034,53.080558128951516
48,48087,155,15,1048,1218,12.725779967159278,86.04269293924466,1.2315270935960592,87.27422003284072
48,48089,2403,69,7440,9912,24.243341404358354,75.06053268765133,0.6961259079903147,75.75665859564165
48,48091,24369,1313,62260,87942,27.71030906733984,70.79666143594642,1.4930294967137432,72.28969093266016
48,48093,852,55,5177,6084,14.003944773175542,85.09204470742932,0.9040105193951348,85.99605522682445
48,48095,197,13,1058,1268,15.53627760252366,83.4384858044164,1.025236593059937,84.46372239747635
48,48097,3205,182,15579,18966,16.89866076136244,82.14172730148687,0.9596119371506907,83.10133923863756
48,48099,7542,486,15397,23425,32.19637139807897,65.72892209178228,2.074706510138741,67.80362860192102
48,48101,113,9,543,665,16.99248120300752,81.65413533834587,1.3533834586466165,83.00751879699249
48,48103,241,15,1247,1503,16.03459747172322,82.96739853626082,0.998003992015968,83.96540252827678
48,48105,344,10,1219,1573,21.86904005085823,77.49523204068659,0.6357279084551812,78.13095994914177
48,48107,527,30,1396,1953,26.984126984126984,71.47977470558115,1.5360983102918586,73.01587301587301
48,48109,438,11,415,864,50.69444444444444,48.032407407407405,1.2731481481481481,49.30555555555556
48,48111,196,23,1386,1605,12.21183800623053,86.35514018691589,1.4330218068535825,87.78816199376948
48,48113,598576,15986,307076,921638,64.94697484261717,33.31850466235116,1.7345204950316717,35.053025157382834
48,48115,808,30,2951,3789,21.324887833201373,77.88334652942729,0.791765637371338,78.67511216679863
48,48117,1263,52,3293,4608,27.408854166666668,71.46267361111111,1.128472222222222,72.59114583333333
48,48119,403,27,2157,2587,15.577889447236181,83.37843061461152,1.0436799381522999,84.42211055276383
48,48121,188695,6789,222480,417964,45.146232689896735,53.229464738589925,1.624302571513336,54.853767310103265
48,48123,1494,57,6567,8118,18.403547671840354,80.89430894308943,0.7021433850702143,81.59645232815964
48,48125,130,5,850,985,13.19796954314721,86.29441624365482,0.5076142131979695,86.80203045685279
48,48127,2264,18,1384,3666,61.75668303327878,37.752318603382435,0.4909983633387889,38.24331696672122
48,48129,198,12,1438,1648,12.014563106796118,87.25728155339806,0.7281553398058253,87.98543689320388
48,48131,2573,35,2442,5050,50.95049504950495,48.35643564356435,0.6930693069306931,49.04950495049505
48,48133,982,73,7216,8271,11.872808608390763,87.24458952968203,0.8826018619272156,88.12719139160924
48,48135,11310,521,32586,44417,25.463223540536283,73.36380214782629,1.172974311637436,74.53677645946371
48,48137,166,5,893,1064,15.601503759398497,83.92857142857143,0.4699248120300752,84.3984962406015
48,48139,27513,1402,56651,85566,32.15412663908562,66.20737208704391,1.6385012738704625,67.84587336091438
48,48141,168801,4540,81235,254576,66.30672176481679,31.90992080950286,1.7833574256803468,33.693278235183215
48,48143,2914,254,13669,16837,17.307121221120152,81.1842964898735,1.5085822890063552,82.69287877887984
48,48145,1899,57,4177,6133,30.963639328224364,68.10696233490951,0.9293983368661339,69.03636067177564
48,48147,2638,181,12150,14969,17.623087714610193,81.16774667646469,1.209165608925112,82.3769122853898
48,48149,2650,111,10163,12924,20.50448777468276,78.6366450015475,0.8588672237697307,79.49551222531724
48,48151,352,26,1448,1826,19.27710843373494,79.29901423877328,1.4238773274917853,80.72289156626506
48,48153,437,17,1581,2035,21.474201474201475,77.69041769041769,0.8353808353808353,78.52579852579852
48,48155,99,7,445,551,17.96733212341198,80.76225045372051,1.2704174228675136,82.03266787658802
48,48157,195191,5047,157595,357833,54.54807130700634,44.04149421657589,1.4104344764177703,45.45192869299366
48,48159,803,44,4153,5000,16.06,83.06,0.88,83.94
48,48161,1629,83,6966,8678,18.771606360912653,80.27195206268726,0.9564415764000921,81.22839363908734
48,48163,2421,31,2812,5264,45.99164133738602,53.419452887538,0.5889057750759878,54.00835866261398
48,48165,572,65,5323,5960,9.59731543624161,89.31208053691276,1.0906040268456376,90.40268456375838
48,48167,58247,2290,93306,153843,37.86132615718622,60.650143327938224,1.488530514875555,62.13867384281378
48,48169,231,9,1411,1651,13.99152029073289,85.4633555420957,0.5451241671714113,86.0084797092671
48,48171,3163,159,12495,15817,19.997471075425175,78.99728140608207,1.005247518492761,80.00252892457482
48,48173,39,3,611,653,5.972434915773354,93.56814701378255,0.45941807044410415,94.02756508422665
48,48175,872,25,3081,3978,21.920563097033686,77.45098039215686,0.628456510809452,78.07943690296631
48,48177,1894,72,5568,7534,25.13936819750465,73.9049641624635,0.9556676400318556,74.86063180249535
48,48179,820,113,6812,7745,10.587475790832796,87.95351839896708,1.459005810200129,89.4125242091672
48,48181,14223,761,43776,58760,24.205241660993874,74.499659632403,1.2950987066031312,75.79475833900612
48,48183,14657,691,32352,47700,30.727463312368975,67.82389937106919,1.448637316561845,69.27253668763103
48,48185,2831,148,9419,12398,22.834328117438297,75.9719309566059,1.1937409259557992,77.1656718825617
48,48187,28706,1253,47423,77382,37.09648238608462,61.28427799746711,1.6192396164482696,62.90351761391538
48,48189,2271,127,7162,9560,23.755230125523013,74.9163179916318,1.3284518828451881,76.24476987447699
48,48191,167,6,992,1165,14.334763948497853,85.15021459227468,0.5150214592274678,85.66523605150215
48,48193,641,93,3613,4347,14.74580170232344,83.11479181044399,2.139406487232574,85.25419829767657
48,48195,166,32,1848,2046,8.113391984359726,90.32258064516128,1.5640273704789833,91.88660801564028
48,48197,241,9,1330,1580,15.253164556962027,84.17721518987342,0.569620253164557,84.74683544303798
48,48199,3449,300,23806,27555,12.516784612592996,86.39448375975321,1.0887316276537833,87.483215387407
48,48201,918193,21995,700630,1640818,55.959466558753014,42.70004351488099,1.3404899263659955,44.040533441246986
48,48203,7812,332,21318,29462,26.51551150634716,72.35761319666011,1.1268752969927365,73.48448849365283
48,48205,195,15,1866,2076,9.393063583815028,89.88439306358381,0.7225433526011561,90.60693641618496
48,48207,353,21,1837,2211,15.965626413387607,83.08457711442786,0.9497964721845319,84.03437358661239
48,48209,59213,2182,47427,108822,54.412710665122866,43.58218007388212,2.0051092609950194,45.587289334877134
48,48211,206,28,1486,1720,11.976744186046512,86.39534883720931,1.627906976744186,88.02325581395348
48,48213,7048,333,28816,36197,19.47122689725668,79.60880735972594,0.9199657430173771,80.52877310274332
48,48215,128199,2158,90527,220884,58.03906122670723,40.98395537929411,0.97698339399866,41.96093877329277
48,48217,2829,145,11869,14843,19.05948932156572,79.96361921444452,0.9768914639897595,80.94051067843428
48,48219,1481,76,6534,8091,18.304288715857126,80.7563959955506,0.9393152885922631,81.69571128414287
48,48221,5641,452,26487,32580,17.314303253529772,81.29834254143647,1.387354205033763,82.68569674647023
48,48223,3043,176,12713,15932,19.09992467988953,79.79538036655786,1.1046949535525985,80.90007532011047
48,48225,2312,63,7050,9425,24.53050397877984,74.80106100795756,0.6684350132625995,75.46949602122015
48,48227,2017,127,7899,10043,20.083640346510006,78.65179727173155,1.2645623817584388,79.91635965348999
48,48229,371,15,771,1157,32.0656871218669,66.63785652549697,1.296456352636128,67.9343128781331
48,48231,8879,503,29135,38517,23.052158787029104,75.64192434509437,1.305916867876522,76.9478412129709
48,48233,957,125,7659,8741,10.948404072760553,87.6215535979865,1.4300423292529458,89.05159592723945
48,48235,120,10,759,889,13.498312710911136,85.37682789651294,1.124859392575928,86.50168728908886
48,48237,331,33,3415,3779,8.758930934109554,90.36782217517862,0.8732468907118285,91.24106906589044
48,48239,1018,76,5116,6210,16.392914653784217,82.38325281803543,1.2238325281803542,83.60708534621578
48,48241,2906,110,12453,15469,18.7859590148038,80.50294136660418,0.7110996185920228,81.21404098519619
48,48243,501,20,783,1304,38.420245398773005,60.04601226993865,1.5337423312883436,61.579754601226995
48,48245,46022,1108,47535,94665,48.615644641631015,50.21391221676438,1.1704431416046057,51.384355358368985
48,48247,1197,6,831,2034,58.849557522123895,40.85545722713864,0.2949852507374631,41.150442477876105
48,48249,6025,93,7389,13507,44.60650033316058,54.704967794476936,0.6885318723624787,55.39349966683942
48,48251,16418,987,54523,71928,22.82560338115894,75.80219107996886,1.3722055388722054,77.17439661884106
48,48253,989,81,5621,6691,14.781049170527574,84.00836945150202,1.210581377970408,85.21895082947242
48,48255,1220,50,3959,5229,23.331420921782367,75.71237330273475,0.9562057754828839,76.66857907821763
48,48257,18290,671,37474,56435,32.40896606715691,66.40205546203597,1.1889784708071232,67.59103393284309
48,48259,6008,347,20064,26419,22.74120897838677,75.9453423672357,1.3134486543775314,77.25879102161323
48,48261,65,2,127,194,33.50515463917525,65.4639175257732,1.0309278350515463,66.49484536082474
48,48263,47,4,411,462,10.173160173160174,88.96103896103897,0.8658008658008658,89.82683982683983
48,48265,6510,370,20858,27738,23.46960847934242,75.1964813613094,1.3339101593481866,76.53039152065759
48,48267,284,21,1987,2292,12.390924956369982,86.69284467713787,0.9162303664921465,87.60907504363001
48,48269,8,0,151,159,5.031446540880504,94.9685534591195,0,94.96855345911949
48,48271,446,13,1144,1603,27.822832189644416,71.36618839675609,0.8109794135995009,72.17716781035558
48,48273,5359,125,5557,11041,48.537270174803005,50.33058599764514,1.1321438275518523,51.462729825196995
48,48275,265,11,1180,1456,18.20054945054945,81.04395604395604,0.7554945054945055,81.79945054945055
48,48277,4420,220,16698,21338,20.714218764645235,78.25475677195614,1.0310244633986316,79.28578123535476
48,48279,835,46,3513,4394,19.003186162949476,79.94993172507967,1.0468821119708693,80.99681383705052
48,48281,2134,169,8070,10373,20.572640509013787,77.79812975995372,1.6292297310324881,79.42735949098622
48,48283,1052,19,1335,2406,43.72402327514547,55.48628428927681,0.7896924355777223,56.27597672485453
48,48285,1333,60,8802,10195,13.075036782736635,86.33643943109367,0.588523786169691,86.92496321726337
48,48287,1745,82,6248,8075,21.609907120743035,77.37461300309597,1.0154798761609907,78.39009287925697
48,48289,1072,78,7522,8672,12.361623616236162,86.73892988929889,0.8994464944649446,87.63837638376384
48,48291,5779,247,23288,29314,19.714129767346662,79.44326942757726,0.8426008050760729,80.28587023265334
48,48293,2213,93,6786,9092,24.34007919049714,74.63704355477343,1.0228772547294325,75.65992080950286
48,48295,131,17,1203,1351,9.696521095484826,89.04515173945225,1.2583271650629164,90.30347890451517
48,48297,819,36,4198,5053,16.208193152582623,83.0793587967544,0.7124480506629725,83.79180684741738
48,48299,3167,115,9996,13278,23.851483657177287,75.28242205151379,0.8660942913089321,76.14851634282272
48,48301,4,2,60,66,6.0606060606060606,90.9090909090909,3.0303030303030303,93.93939393939394
48,48303,39757,1887,78560,120204,33.07460650227946,65.35556221090812,1.569831286812419,66.92539349772053
48,48305,428,12,1853,2293,18.665503706934146,80.81116441343218,0.5233318796336677,81.33449629306585
48,48307,490,42,2898,3430,14.285714285714285,84.48979591836735,1.2244897959183674,85.71428571428572
48,48309,36550,1635,59432,97617,37.44224878863312,60.88283803026112,1.67491318110575,62.55775121136688
48,48311,53,3,460,516,10.271317829457365,89.14728682170544,0.5813953488372093,89.72868217054264
48,48313,1084,40,4165,5289,20.495367744375116,78.74834562299111,0.7562866326337683,79.50463225562488
48,48315,1331,54,3459,4844,27.47729149463253,71.40792733278283,1.1147811725846408,72.52270850536746
48,48317,288,15,1857,2160,13.333333333333334,85.97222222222223,0.6944444444444444,86.66666666666667
48,48319,566,26,2108,2700,20.962962962962965,78.07407407407408,0.962962962962963,79.03703703703704
48,48321,3726,148,9836,13710,27.177242888402624,71.74325309992706,1.0795040116703136,72.82275711159738
48,48323,8324,133,6881,15338,54.27043943147738,44.86243317251271,0.8671273960099101,45.72956056852262
48,48325,6731,238,15599,22568,29.825416518964904,69.11999291031549,1.054590570719603,70.1745834810351
48,48327,196,8,819,1023,19.159335288367547,80.05865102639295,0.7820136852394917,80.84066471163246
48,48329,12258,1031,45463,58752,20.863970588235293,77.38119553376906,1.7548338779956425,79.13602941176471
48,48331,2475,98,7950,10523,23.519908771262948,75.54879787132947,0.9312933574075835,76.48009122873705
48,48333,271,17,2214,2502,10.831334932054357,88.48920863309353,0.6794564348521183,89.16866506794564
48,48335,397,12,2169,2578,15.399534522885958,84.13498836307215,0.46547711404189296,84.60046547711404
48,48337,1097,102,8613,9812,11.180187525479006,87.78026905829597,1.0395434162250305,88.819812474521
48,48339,74255,3696,193224,271175,27.38268645708491,71.25435604314558,1.3629574997695215,72.6173135429151
48,48341,1059,87,4356,5502,19.247546346782986,79.17121046892039,1.5812431842966195,80.75245365321702
48,48343,1664,43,3841,5548,29.992790194664742,69.23215573179525,0.7750540735400144,70.00720980533526
48,48345,46,2,604,652,7.05521472392638,92.63803680981594,0.3067484662576687,92.94478527607362
48,48347,8989,407,17359,26755,33.5974584189871,64.88133059241264,1.5212109886002616,66.4025415810129
48,48349,5097,221,13787,19105,26.678879874378435,72.16435488092122,1.1567652447003403,73.32112012562156
48,48351,1175,39,4882,6096,19.2749343832021,80.08530183727034,0.639763779527559,80.7250656167979
48,48353,1161,64,4127,5352,21.692825112107624,77.11136023916293,1.195814648729447,78.30717488789237
48,48355,60749,1768,64467,126984,47.83988533988534,50.76781326781327,1.3923013923013923,52.16011466011466
48,48357,302,42,2811,3155,9.572107765451664,89.09667194928684,1.3312202852614898,90.42789223454834
48,48359,81,11,917,1009,8.02775024777007,90.8820614469772,1.0901883052527255,91.97224975222993
48,48361,6354,450,29170,35974,17.662756435203203,81.08634013454162,1.2509034302551842,82.3372435647968
48,48363,2177,131,10170,12478,17.446706202917134,81.50344606507454,1.0498477320083346,82.55329379708286
48,48365,2057,73,9322,11452,17.96192804750262,81.40062871114215,0.6374432413552218,82.03807195249738
48,48367,12789,1061,61584,75434,16.95389346978816,81.63957896969536,1.406527560516478,83.04610653021184
48,48369,488,27,2133,2648,18.429003021148034,80.55135951661632,1.0196374622356497,81.57099697885197
48,48371,1378,71,3213,4662,29.558129558129558,68.91891891891892,1.522951522951523,70.44187044187044
48,48373,5353,223,18496,24072,22.2374543037554,76.8361581920904,0.926387504154204,77.7625456962446
48,48375,9867,578,22732,33177,29.740482864635137,68.51734635440214,1.7421707809627152,70.25951713536486
48,48377,1463,33,721,2217,65.99007668019846,32.521425349571494,1.4884979702300407,34.009923319801544
48,48379,841,56,5147,6044,13.914626075446723,85.1588352084712,0.9265387160820648,86.08537392455328
48,48381,12750,1065,50597,64412,19.794448239458486,78.55213314289263,1.6534186176488854,80.20555176054151
48,48383,172,10,942,1124,15.302491103202847,83.80782918149467,0.8896797153024912,84.69750889679716
48,48385,320,19,1643,1982,16.145307769929364,82.89606458123107,0.958627648839556,83.85469223007064
48,48387,1244,43,4513,5800,21.448275862068968,77.8103448275862,0.7413793103448276,78.55172413793103
48,48389,1394,40,2249,3683,37.849579147434156,61.06434971490633,1.0860711376595167,62.150420852565844
48,48391,1108,48,2210,3366,32.91740938799762,65.65656565656566,1.4260249554367201,67.08259061200238
48,48393,17,4,529,550,3.090909090909091,96.18181818181817,0.7272727272727273,96.9090909090909
48,48395,2359,90,5631,8080,29.195544554455445,69.69059405940594,1.1138613861386137,70.80445544554456
48,48397,18149,801,38842,57792,31.404000553709853,67.20999446290143,1.3860049833887045,68.59599944629015
48,48399,531,49,3682,4262,12.458939465039888,86.39136555607696,1.1496949788831534,87.54106053496011
48,48401,4624,232,16511,21367,21.640848036692095,77.27336547011747,1.0857864931904337,78.35915196330791
48,48403,662,32,4767,5461,12.122321919062443,87.29170481596778,0.5859732649697857,87.87767808093756
48,48405,979,14,3005,3998,24.487243621810904,75.16258129064532,0.3501750875437719,75.5127563781891
48,48407,2332,142,10154,12628,18.466898954703833,80.40861577446944,1.124485270826734,81.53310104529616
48,48409,8971,384,16495,25850,34.704061895551256,63.810444874274665,1.4854932301740813,65.29593810444874
48,48411,287,7,2308,2602,11.029976940814757,88.70099923136048,0.2690238278247502,88.97002305918524
48,48413,211,8,939,1158,18.221070811744386,81.0880829015544,0.690846286701209,81.77892918825562
48,48415,818,69,4978,5865,13.947144075021312,84.8763853367434,1.1764705882352942,86.05285592497869
48,48417,130,14,1484,1628,7.985257985257984,91.15479115479116,0.85995085995086,92.01474201474201
48,48419,2058,43,7962,10063,20.45115770644937,79.12153433369771,0.4273079598529266,79.54884229355063
48,48421,91,14,885,990,9.191919191919192,89.39393939393939,1.4141414141414141,90.8080808080808
48,48423,29343,1632,68546,99521,29.484229459109134,68.87591563589595,1.6398549049949258,70.51577054089087
48,48425,768,73,4099,4940,15.546558704453442,82.97570850202429,1.4777327935222673,84.45344129554655
48,48427,9099,155,8224,17478,52.059732234809474,47.053438608536446,0.8868291566540794,47.94026776519053
48,48429,396,18,3385,3799,10.423795735719926,89.1023953672019,0.47380889707817847,89.57620426428008
48,48431,51,4,584,639,7.981220657276995,91.39280125195619,0.6259780907668232,92.01877934272301
48,48433,116,5,615,736,15.760869565217392,83.55978260869566,0.6793478260869565,84.23913043478261
48,48435,322,13,1222,1557,20.68079640333976,78.48426461143224,0.8349389852280027,79.31920359666024
48,48437,478,33,1842,2353,20.314492137696558,78.2830429239269,1.4024649383765404,79.68550786230344
48,48439,411567,13389,409741,834697,49.307353446819626,49.08859142898561,1.6040551241947678,50.692646553180374
48,48441,14489,996,39439,54924,26.38008885004734,71.80649624936277,1.813414900589906,73.61991114995266
48,48443,119,5,334,458,25.982532751091703,72.92576419213974,1.0917030567685588,74.0174672489083
48,48445,757,42,2809,3608,20.981152993348115,77.85476718403548,1.164079822616408,79.01884700665188
48,48447,82,11,806,899,9.121245828698555,89.65517241379311,1.2235817575083427,90.87875417130144
48,48449,2852,115,7563,10530,27.084520417853753,71.82336182336182,1.0921177587844255,72.91547958214625
48,48451,12106,656,32129,44891,26.967543605622506,71.57113898108753,1.4613174132899691,73.03245639437749
48,48453,435860,13152,161337,610349,71.41160221447073,26.43356505867954,2.1548327268497203,28.588397785529267
48,48455,1323,36,5579,6938,19.068895935428078,80.41222254251946,0.5188815220524646,80.93110406457193
48,48457,1390,62,8095,9547,14.559547501833038,84.79103383261759,0.6494186655493872,85.44045249816696
48,48459,2869,206,15775,18850,15.220159151193634,83.6870026525199,1.0928381962864722,84.77984084880637
48,48461,169,20,1176,1365,12.380952380952381,86.15384615384616,1.465201465201465,87.61904761904762
48,48463,4066,97,6160,10323,39.387774871645846,59.67257580160806,0.9396493267461009,60.612225128354154
48,48465,6401,177,7839,14417,44.398973434140245,54.373309287646535,1.2277172782132206,55.601026565859755
48,48467,3419,208,22126,25753,13.276123170116103,85.91620393740536,0.8076728924785461,86.72387682988389
48,48469,10371,487,23347,34205,30.320128636164302,68.25610290893144,1.4237684549042537,69.6798713638357
48,48471,7875,398,15368,23641,33.31077365593672,65.00571041834102,1.683515925722262,66.68922634406329
48,48473,8130,281,14206,22617,35.94641199098024,62.811159747092894,1.2424282619268692,64.05358800901976
48,48475,761,35,3238,4034,18.86465047099653,80.26772434308378,0.8676251859196827,81.13534952900346
48,48477,4254,207,12949,17410,24.43423319931074,74.37679494543366,1.1889718552556001,75.56576680068926
48,48479,41820,679,25898,68397,61.143032589148646,37.864233811424484,0.9927335994268754,38.856967410851354
48,48481,4671,146,11892,16709,27.95499431444132,71.17122508827578,0.8737805972829015,72.04500568555868
48,48483,168,10,2158,2336,7.191780821917808,92.38013698630137,0.4280821917808219,92.8082191780822
48,48485,13024,799,31930,45753,28.465892946910586,69.78777347933469,1.7463335737547265,71.53410705308941
48,48487,954,44,3520,4518,21.115537848605577,77.91057990261177,0.9738822487826472,78.88446215139442
48,48489,3097,41,2437,5575,55.55156950672646,43.71300448430493,0.7354260089686099,44.44843049327354
48,48491,142457,6590,138649,287696,49.51650353150548,48.19288415549747,2.2906123129970526,50.48349646849452
48,48493,6350,199,18457,25006,25.393905462688952,73.81028553147245,0.7958090058385988,74.60609453731105
48,48495,358,15,1753,2126,16.839134524929445,82.45531514581373,0.7055503292568204,83.16086547507055
48,48497,4953,358,26986,32297,15.33578970182989,83.55574821190824,1.108462086261882,84.6642102981701
48,48499,3487,216,18962,22665,15.384954776086476,83.66203397308625,0.9530112508272668,84.61504522391353
48,48501,419,42,2172,2633,15.91340676034941,82.49145461450816,1.595138625142423,84.0865932396506
48,48503,1036,94,7112,8242,12.569764620237805,86.28973550109197,1.1404998786702256,87.4302353797622
48,48505,1820,15,2032,3867,47.064908197569174,52.54719420739591,0.3878975950349108,52.935091802430826
48,48507,2864,25,1490,4379,65.40306005937428,34.026033340945425,0.5709065996802923,34.59693994062572
49,49001,357,48,2695,3100,11.516129032258064,86.93548387096774,1.5483870967741935,88.48387096774194
49,49003,4473,1002,21548,27023,16.552566332383524,79.73948118269622,3.707952484920253,83.44743366761648
49,49005,16650,2852,38032,57534,28.93940974032746,66.10352139604407,4.957068863628463,71.06059025967254
49,49007,2392,284,6693,9369,25.5310065108336,71.43772014089016,3.03127334827623,74.4689934891664
49,49009,111,12,496,619,17.932148626817447,80.12924071082391,1.938610662358643,82.06785137318255
49,49011,57396,8267,104095,169758,33.810483158378396,61.31964325687155,4.8698735847500565,66.18951684162161
49,49013,843,168,7513,8524,9.889723134678555,88.13937118723604,1.9709056780854057,90.11027686532145
49,49015,572,86,4207,4865,11.757451181911614,86.47482014388488,1.7677286742034943,88.24254881808838
49,49017,514,60,2158,2732,18.814055636896047,78.98975109809663,2.1961932650073206,81.18594436310396
49,49019,2806,131,2248,5185,54.11764705882353,43.35583413693346,2.526518804243009,45.88235294117647
49,49021,4892,1009,18989,24890,19.6544797107272,76.29168340699076,4.053836882282041,80.3455202892728
49,49023,645,152,5087,5884,10.961930659415364,86.45479265805575,2.583276682528892,89.03806934058464
49,49025,1083,99,2998,4180,25.90909090909091,71.7224880382775,2.368421052631579,74.0909090909091
49,49027,624,132,5404,6160,10.129870129870131,87.72727272727273,2.142857142857143,89.87012987012987
49,49029,1086,245,5181,6512,16.676904176904177,79.5608108108108,3.7622850122850124,83.32309582309583
49,49031,86,12,773,871,9.873708381171067,88.74856486796784,1.377726750861079,90.12629161882893
49,49033,180,26,1157,1363,13.206162876008804,84.88628026412326,1.9075568598679384,86.7938371239912
49,49035,289906,20886,230174,540966,53.590428973355074,42.54869991829431,3.8608711083506173,46.409571026644926
49,49037,3113,229,3535,6877,45.26683146720954,51.40322815181039,3.3299403809800787,54.73316853279046
49,49039,1794,372,10459,12625,14.209900990099008,82.84356435643564,2.9465346534653465,85.79009900990098
49,49041,1084,226,9052,10362,10.46130090716078,87.3576529627485,2.181046130090716,89.53869909283922
49,49043,15244,590,10252,26086,58.43747604078816,39.300774361726596,2.2617495974852413,41.56252395921184
49,49045,8943,1549,21014,31506,28.385069510569416,66.69840665270107,4.916523836729512,71.61493048943058
49,49047,1663,379,13261,15303,10.867150231980657,86.65621120041823,2.4766385676011238,89.13284976801934
49,49049,76033,15441,192812,284286,26.74524950226181,67.82324841884581,5.4315020788923825,73.25475049773819
49,49051,6187,597,10795,17579,35.19540360657602,61.40849877694977,3.396097616474202,64.80459639342398
49,49053,20530,2633,67294,90457,22.69586654432493,74.3933581701803,2.9107752854947657,77.30413345567507
49,49055,365,27,1229,1621,22.516964836520668,75.81739666872302,1.6656384947563232,77.48303516347933
49,49057,40695,4759,65949,111403,36.5295369065465,59.19858531637389,4.271877777079612,63.4704630934535
50,50001,14967,763,6292,22022,67.9638543274907,28.57142857142857,3.4647171010807374,32.036145672509306
50,50003,12705,643,7114,20462,62.09070472094614,34.76688495748216,3.142410321571694,37.90929527905386
50,50005,9011,607,6551,16169,55.73010081019234,40.51580184303297,3.7540973467746923,44.26989918980766
50,50007,74961,2937,21017,98915,75.78324824344134,21.247535763028864,2.9692159935297986,24.216751756558665
50,50009,1405,110,1773,3288,42.73114355231144,53.92335766423357,3.345498783454988,57.26885644768856
50,50011,13611,945,11274,25830,52.6945412311266,43.64692218350755,3.6585365853658534,47.3054587688734
50,50013,2905,136,1810,4851,59.884559884559884,37.311894454751595,2.803545660688518,40.115440115440116
50,50015,10240,512,4163,14915,68.65571572242709,27.91149849145156,3.432785786121354,31.34428427757291
50,50017,10304,631,6187,17122,60.17988552739166,36.134797336759725,3.6853171358486163,39.82011447260834
50,50019,7147,437,6512,14096,50.70232690124858,46.19750283768445,3.1001702610669692,49.29767309875142
50,50021,18230,1068,14672,33970,53.66499852811304,43.191050927288785,3.1439505445981752,46.33500147188696
50,50023,25191,1188,8928,35307,71.34845781289829,25.286770328829977,3.3647718582717303,28.65154218710171
50,50025,18767,828,6440,26035,72.08373343575956,24.735932398694064,3.18033416554638,27.916266564240445
50,50027,23376,1099,9971,34446,67.86274168263368,28.94675724322127,3.1905010741450384,32.13725831736632
51,51001,7578,212,9172,16962,44.67633533781394,54.07381205046574,1.249852611720316,55.32366466218606
51,51003,42466,1387,20804,64657,65.67889014337194,32.1759438266545,2.145166029973553,34.321109856628055
51,51005,2243,101,5859,8203,27.343654760453497,71.42508838229917,1.2312568572473486,72.65634523954651
51,51007,2411,93,5390,7894,30.542183937167465,68.27970610590322,1.1781099569293134,69.45781606283253
51,51009,5672,292,11041,17005,33.35489561893561,64.92796236401058,1.7171420170538076,66.64510438106439
51,51011,2418,148,6702,9268,26.089771255934398,72.31333621061718,1.5968925334484247,73.9102287440656
51,51013,105344,3077,22318,130739,80.57580370050252,17.070652215482756,2.3535440840147164,19.42419629949748
51,51015,10840,724,30714,42278,25.639812668527366,72.64771275840863,1.712474573064005,74.36018733147263
51,51017,646,21,1834,2501,25.829668132746903,73.33066773290685,0.8396641343462616,74.1703318672531
51,51019,12176,893,35600,48669,25.017978590067603,73.14717787503339,1.8348435348990118,74.9820214099324
51,51021,532,44,2903,3479,15.29175050301811,83.44351825237138,1.2647312446105201,84.70824949698189
51,51023,5700,324,15099,21123,26.98480329498651,71.48132367561426,1.533873029399233,73.0151967050135
51,51025,4552,39,3357,7948,57.272269753397076,42.23704076497232,0.4906894816305989,42.727730246602924
51,51027,1587,59,8311,9957,15.938535703525158,83.46891634026314,0.5925479562117104,84.06146429647484
51,51029,3471,114,4544,8129,42.69897896420224,55.89863451839094,1.402386517406815,57.30102103579776
51,51031,8070,586,21245,29901,26.98906391090599,71.05113541353131,1.9598006755626902,73.010936089094
51,51033,7657,295,8336,16288,47.010068762278976,51.178781925343806,1.8111493123772102,52.989931237721024
51,51035,2842,156,12659,15657,18.15162547103532,80.85201507313023,0.9963594558344511,81.84837452896468
51,51036,2624,56,1761,4441,59.085791488403515,39.65323125422202,1.2609772573744653,40.914208511596485
51,51037,2317,59,3815,6191,37.425294782749155,61.621708932321106,0.9529962849297368,62.574705217250845
51,51041,106935,3694,93326,203955,52.43068323894977,45.75813292147778,1.8111838395724549,47.56931676105023
51,51043,3920,225,5192,9337,41.983506479597295,55.60672592909929,2.4097675913034164,58.016493520402705
51,51045,587,47,2536,3170,18.517350157728707,80,1.4826498422712935,81.48264984227129
51,51047,10617,487,16012,27116,39.15400501548901,59.05000737571914,1.7959876087918571,60.84599498451099
51,51049,2227,67,3019,5313,41.91605495953322,56.82288725766986,1.2610577827969132,58.08394504046678
51,51051,1503,56,5748,7307,20.569317093198304,78.66429451211168,0.7663883946900233,79.43068290680169
51,51053,6224,173,8695,15092,41.24039226080043,57.61330506228466,1.1463026769149218,58.75960773919957
51,51057,3038,65,3075,6178,49.17449012625445,49.77338944642279,1.0521204273227582,50.82550987374555
51,51059,419943,12899,168401,601243,69.84580277857705,28.00880841855955,2.145388802863401,30.154197221422947
51,51061,17565,1000,25106,43671,40.22119942295802,57.4889514780976,2.2898490989443796,59.77880057704198
51,51063,3004,183,6225,9412,31.91670208244794,66.13897152571185,1.944326391840204,68.08329791755206
51,51065,7414,277,8155,15846,46.78783289158147,51.46409188438723,1.7480752240313011,53.21216710841853
51,51067,8381,428,20895,29704,28.215055211419337,70.34406140587126,1.4408833827093994,71.78494478858066
51,51069,17207,953,30558,48718,35.319594400426944,62.72424976394761,1.9561558356254363,64.68040559957305
51,51071,2156,146,6876,9178,23.490956635432557,74.91828285029418,1.5907605142732621,76.50904336456745
51,51073,6964,445,14875,22284,31.251121881170345,66.751929635613,1.9969484832166577,68.74887811882965
51,51075,6685,301,9966,16952,39.43487494100991,58.7895233600755,1.7756016989145824,60.56512505899009
51,51077,1535,67,6529,8131,18.878366744557866,80.29762636822039,0.8240068872217439,81.12163325544213
51,51079,4163,241,6866,11270,36.93877551020408,60.922803904170365,2.1384205856255547,63.06122448979592
51,51081,2627,33,1914,4574,57.43331875819852,41.84521206821163,0.7214691735898557,42.56668124180148
51,51083,7666,164,10418,18248,42.01008329679965,57.09118807540552,0.8987286277948269,57.98991670320035
51,51085,25307,1363,44318,70988,35.64968727108807,62.430269904772636,1.920042824139291,64.35031272891193
51,51087,116572,3287,63440,183299,63.596637188418924,34.610117894805754,1.7932449167753235,36.403362811581076
51,51089,9127,253,16725,26105,34.96265083317372,64.06818617123157,0.9691629955947136,65.03734916682629
51,51091,417,24,1092,1533,27.20156555772994,71.23287671232876,1.5655577299412915,72.79843444227006
51,51093,9399,350,13707,23456,40.07077080491132,58.43707366984994,1.4921555252387448,59.92922919508868
51,51095,25553,933,23153,49639,51.477668768508636,46.64276073248857,1.8795704990028004,48.522331231491364
51,51097,1590,75,2450,4115,38.639125151883356,59.53827460510328,1.8226002430133657,61.360874848116644
51,51099,5404,377,8446,14227,37.984114711464116,59.36599423631124,2.6498910522246435,62.015885288535884
51,51101,3260,157,7320,10737,30.362298593648134,68.17546800782341,1.462233398528453,69.63770140635187
51,51103,3368,87,3697,7152,47.0917225950783,51.69183445190156,1.2164429530201342,52.9082774049217
51,51105,1489,93,8365,9947,14.969337488690057,84.0957072484166,0.9349552628933346,85.03066251130994
51,51107,138372,4516,82088,224976,61.505227224237245,36.48744754996088,2.0073252258018632,38.494772775762755
51,51109,8269,353,13294,21916,37.730425260083955,60.658879357547,1.6106953823690453,62.269574739916045
51,51111,2418,47,3537,6002,40.28657114295235,58.9303565478174,0.7830723092302566,59.71342885704765
51,51113,2698,135,5300,8133,33.17349071683266,65.16660518873725,1.6599040944300998,66.82650928316734
51,51115,1825,103,3901,5829,31.308972379481904,66.92400068622405,1.767026934294047,68.6910276205181
51,51117,6803,138,9266,16207,41.97568951687543,57.17282655642624,0.8514839266983402,58.02431048312457
51,51119,2491,98,4196,6785,36.71333824613117,61.84229918938836,1.4443625644804716,63.28666175386883
51,51121,23218,1190,20629,45037,51.553167395696875,45.80456069454005,2.642271909763084,48.446832604303125
51,51125,4327,179,4812,9318,46.437003648851686,51.64198325820991,1.9210130929383988,53.562996351148314
51,51127,4610,215,9636,14461,31.878846552797178,66.63439596155176,1.4867574856510615,68.12115344720283
51,51131,3667,110,2955,6732,54.471182412358885,43.894830659536545,1.6339869281045754,45.528817587641115
51,51133,3252,78,4485,7815,41.61228406909789,57.38963531669866,0.998080614203455,58.38771593090211
51,51135,2971,80,4027,7078,41.975134218705854,56.89460299519639,1.1302627860977676,58.024865781294146
51,51137,7995,333,12426,20754,38.52269442035271,59.872795605666376,1.6045099739809192,61.47730557964729
51,51139,3007,162,9345,12514,24.02908742208726,74.67636247402909,1.2945501038836504,75.97091257791274
51,51141,1954,96,7485,9535,20.492920818038804,78.50026219192449,1.006816990036707,79.50707918196119
51,51143,10115,361,23751,34227,29.552692318929502,69.39258480147252,1.0547228795979782,70.4473076810705
51,51145,5320,358,14055,19733,26.959914863426746,71.22586530177874,1.8142198347945067,73.04008513657325
51,51147,4973,168,4434,9575,51.93733681462142,46.30809399477806,1.754569190600522,48.06266318537858
51,51149,7103,233,10103,17439,40.73054647628878,57.93336773897586,1.336085784735363,59.26945352371122
51,51153,142863,4182,81222,228267,62.58591912102932,35.58201579729002,1.8320650816806634,37.41408087897068
51,51155,4925,334,12127,17386,28.327389853905444,69.751524214885535,1.9210859312090187,71.67261014609456
51,51157,2096,71,2812,4979,42.096806587668205,56.47720425788311,1.4259891544486845,57.903193412331795
51,51159,1513,42,2547,4102,36.88444661140907,62.091662603608,1.023890784982935,63.11555338859093
51,51161,22261,910,34268,57439,38.75589756089069,59.65981301902888,1.5842894200804332,61.24410243910931
51,51163,4022,299,8047,12368,32.519404915912034,65.0630659767141,2.417529107373868,67.48059508408797
51,51165,12644,653,30349,43646,28.969435916235163,69.53443614535124,1.4961279384136004,71.03056408376483
51,51167,2373,116,10879,13368,17.751346499102333,81.38090963494913,0.8677438659485339,82.24865350089766
51,51169,1692,90,9063,10845,15.601659751037344,83.56846473029046,0.8298755186721992,84.39834024896265
51,51171,6836,346,16463,23645,28.91097483611757,69.62571368153944,1.46331148234299,71.08902516388243
51,51173,3008,133,10963,14104,21.327283040272263,77.72972206466251,0.9429948950652297,78.67271695972774
51,51175,3969,87,5730,9786,40.557939914163086,58.55303494788473,0.8890251379521766,59.442060085836914
51,51177,34385,1321,39506,75212,45.71743870658938,52.52619262883582,1.756368664574802,54.28256129341062
51,51179,40245,1376,37636,79257,50.77784927514289,47.486026470848,1.7361242540091095,49.22215072485711
51,51181,2397,40,2025,4462,53.720304796055586,45.383236216943075,0.8964589870013447,46.279695203944414
51,51183,2827,35,2219,5081,55.63865380830545,43.67250541232041,0.6888407793741389,44.36134619169455
51,51185,3205,159,16731,20095,15.949241104752426,83.25951729285892,0.7912416023886539,84.05075889524757
51,51187,6603,365,14069,21037,31.387555259780385,66.87740647430718,1.73503826591244,68.61244474021962
51,51191,6617,389,21678,28684,23.068609677869194,75.575233579696,1.3561567424348069,76.93139032213081
51,51193,4501,90,5318,9909,45.42335250782117,53.6683822787365,0.9082652134423252,54.57664749217883
51,51195,3110,108,13366,16584,18.7530149541727,80.59575494452484,0.6512301013024602,81.2469850458273
51,51197,3143,170,11733,15046,20.889272896450883,77.98085869998671,1.1298684035624087,79.11072710354912
51,51199,17683,680,20241,38604,45.80613407937001,52.43239042586261,1.7614754947673819,54.19386592062999
51,51510,66240,1022,14544,81806,80.97205583942498,17.77864704300418,1.2492971175708383,19.027944160575018
51,51520,2313,125,5347,7785,29.71098265895954,68.68336544637123,1.605651894669236,70.28901734104046
51,51530,825,127,1863,2815,29.307282415630553,66.18117229129663,4.511545293072825,70.69271758436945
51,51540,20696,311,3094,24101,85.87195552051782,12.837641591635201,1.2904028878469773,14.128044479482185
51,51550,66377,2098,58180,126655,52.40772176384667,45.93580987722554,1.656468358927796,47.59227823615333
51,51570,2972,135,6007,9114,32.6091727013386,65.90958964230855,1.4812376563528638,67.3908272986614
51,51580,964,50,1580,2594,37.162683114880494,60.90979182729376,1.927525057825752,62.837316885119506
51,51590,11710,195,7428,19333,60.570009827755655,38.42135209227745,1.008638079966896,39.429990172244345
51,51595,1612,13,754,2379,67.75956284153006,31.693989071038253,0.546448087431694,32.240437158469945
51,51600,9192,203,4002,13397,68.61237590505337,29.872359483466447,1.5152646114801822,31.38762409494663
51,51610,7146,114,1490,8750,81.66857142857143,17.02857142857143,1.302857142857143,18.331428571428575
51,51620,2525,35,1487,4047,62.391895231035335,36.74326661724734,0.8648381517173214,37.608104768964665
51,51630,8517,240,4037,12794,66.57026731280288,31.55385336876661,1.8758793184305143,33.42973268719712
51,51640,777,18,1838,2633,29.510064565134826,69.80630459551843,0.6836308393467527,70.48993543486517
51,51650,46220,1006,18430,65656,70.39722188375777,28.070549530888268,1.532228585353966,29.602778116242234
51,51660,11022,364,5591,16977,64.92313129528185,32.93279142369088,2.144077281027272,35.07686870471815
51,51670,5427,161,4018,9606,56.49594003747658,41.82802415157194,1.6760358109514886,43.50405996252342
51,51678,1797,48,908,2753,65.27424627678896,32.98220123501635,1.7435524881946969,34.72575372321104
51,51680,18048,857,17097,36002,50.13054830287206,47.48902838731182,2.380423309816121,49.86945169712794
51,51683,10356,280,6256,16892,61.30712763438314,37.035282974188966,1.657589391427895,38.69287236561686
51,51685,3913,96,2062,6071,64.45396145610277,33.96475045297315,1.5812880909240652,35.546038543897225
51,51690,3766,73,2165,6004,62.724850099933384,36.05929380413058,1.2158560959360427,37.275149900066616
51,51700,53099,1727,26377,81203,65.39044123985566,32.48279004470278,2.1267687154415476,34.60955876014434
51,51710,64440,1608,23443,89491,72.007240951604075,26.19593031701512,1.7968287313808093,27.992759048395925
51,51720,464,21,1112,1597,29.054477144646214,69.63055729492798,1.3149655604257984,70.94552285535379
51,51730,12389,108,1584,14081,87.98380796818408,11.249201051061714,0.7669909807542078,12.016192031815919
51,51735,2054,160,5605,7819,26.26934390587032,71.68435861363346,2.0462974804962273,73.73065609412969
51,51740,30948,723,12755,44426,69.6619096925224,28.71066492594427,1.6274253815333362,30.3380903074776
51,51750,3358,145,2786,6289,53.39481634600095,44.29957067896327,2.3056129750357766,46.60518365399905
51,51760,92175,1691,16603,110469,83.43969801482768,15.029555802985453,1.5307461821868578,16.560301985172316
51,51770,26773,777,15607,43157,62.03628611812684,36.163310702782866,1.8004031790902981,37.96371388187316
51,51775,5148,220,7685,13053,39.439209377154675,58.87535432467632,1.6854362981690032,60.560790622845325
51,51790,6981,314,5695,12990,53.74133949191686,43.84141647421093,2.4172440338722097,46.25866050808314
51,51800,28676,724,20082,49482,57.9523867264864,40.58445495331636,1.4631583201972433,42.0476132735136
51,51810,117393,5081,105087,227561,51.58748643220938,46.17970566133916,2.232807906451457,48.41251356779062
51,51820,4961,209,5507,10677,46.46436264868409,51.57815865879929,1.9574786925166245,53.53563735131591
51,51830,4790,92,1963,6845,69.97808619430242,28.677867056245432,1.3440467494521549,30.02191380569758
51,51840,6610,213,5221,12044,54.88209897044172,43.34938558618399,1.7685154433742942,45.11790102955828
53,53001,1789,114,3881,5784,30.930152143845092,67.09889349930843,1.970954356846473,69.06984785615491
53,53003,4233,303,7259,11795,35.88808817295464,61.54302670623145,2.568885120813904,64.11191182704536
53,53005,38572,3216,60177,101965,37.82866669935762,59.0173098612269,3.1540234394154854,62.17133330064238
53,53007,19005,906,22476,42387,44.836860358128675,53.02569183947908,2.1374478023922427,55.163139641871325
53,53009,24532,1214,22912,48658,50.41719758313125,47.08783756011344,2.494964856755313,49.58280241686875
53,53011,140095,6804,126079,272978,51.320985573929036,46.1865058722681,2.4925085538028706,48.679014426070964
53,53013,668,60,1754,2482,26.913779210314264,70.66881547139404,2.4174053182917,73.08622078968574
53,53015,23889,1602,34314,59805,39.944820667168294,57.37647353900176,2.6787057938299474,60.055179332831706
53,53017,7787,415,12908,21110,36.88773093320702,61.14637612505921,1.9658929417337754,63.11226906679298
53,53019,1465,92,2735,4292,34.13327120223672,63.723205964585276,2.1435228331780056,65.86672879776327
53,53021,13148,836,17849,31833,41.303050293720354,56.070744196274305,2.6262055100053403,58.696949706279646
53,53023,362,46,1062,1470,24.625850340136054,72.24489795918367,3.1292517006802725,75.37414965986395
53,53025,11674,877,24594,37145,31.428186835374884,66.21079553102706,2.3610176335980615,68.57181316462511
53,53027,17172,1001,19590,37763,45.47308211741652,51.87617509202129,2.6507427905621905,54.52691788258348
53,53029,29171,1575,22698,53444,54.582366589327144,42.47062345632812,2.947009954344735,45.417633410672856
53,53031,17190,522,6921,24633,69.78443551333578,28.096455973693825,2.1191085129704055,30.21556448666422
53,53033,905577,25825,268240,1199642,75.48727036899342,22.36000406788025,2.152725563126333,24.51272963100658
53,53035,89985,5747,61357,157089,57.28281420086703,39.058750135273634,3.6584356638593407,42.71718579913297
53,53037,11004,797,13778,25579,43.01966456859142,53.864498221197074,3.1158372102115015,56.98033543140858
53,53039,5947,283,7223,13453,44.205753363562025,53.69062662603137,2.1036200104066007,55.794246636437975
53,53041,14462,1155,29318,44935,32.18426616223434,65.24535440080116,2.570379436964504,67.81573383776566
53,53043,1711,129,5134,6974,24.533983366790938,73.61628907370232,1.8497275595067393,75.46601663320907
53,53045,17253,1131,18676,37060,46.55423637344846,50.39395574743659,3.0518078791149486,53.44576362655154
53,53047,8788,401,11710,20899,42.04985884492081,56.031389061677594,1.9187520934015982,57.95014115507919
53,53049,6776,267,6930,13973,48.49352322335933,49.595648751162955,1.910828025477707,51.50647677664067
53,53051,2578,189,5655,8422,30.61030634053669,67.14557112324864,2.2441225362146757,69.3896936594633
53,53053,249316,13460,197578,460354,54.15745274288917,42.91871038374816,2.923836873362673,45.84254725711083
53,53055,9606,296,2994,12896,74.48821339950372,23.21650124069479,2.295285359801489,25.51178660049628
53,53057,37338,1863,32030,71231,52.41818870997178,44.96637699877862,2.6154342912495965,47.58181129002822
53,53059,3100,183,3783,7066,43.87206340220776,53.538069629210305,2.589866968581942,56.12793659779224
53,53061,256277,12390,166090,434757,58.94718198901915,38.20295015376406,2.84986785721679,41.05281801098085
53,53063,135511,8925,148244,292680,46.30005466721334,50.650539838731724,3.0494054940549407,53.69994533278666
53,53065,7721,624,19592,27937,27.637183663242293,70.12921931488707,2.233597021870638,72.3628163367577
53,53067,96255,5043,64995,166293,57.882773177463875,39.084627735382725,3.0325990871533977,42.117226822536125
53,53069,1150,63,1711,2924,39.3296853625171,58.515731874145004,2.1545827633378933,60.6703146374829
53,53071,13211,886,15794,29891,44.19725000836372,52.838647084406674,2.964102907229601,55.80274999163628
53,53073,83557,3500,50407,137464,60.78464179712506,36.66923703660594,2.546121166268987,39.21535820287494
53,53075,10570,656,8642,19868,53.20112744111134,43.49708073283672,3.3017918260519425,46.79887255888866
53,53077,43162,1977,50531,95670,45.115501202048705,52.81802027803909,2.066478519912198,54.884498797951295
54,54001,1457,104,5116,6677,21.821177175378164,76.62123708252209,1.5575857420997454,78.17882282462183
54,54003,17186,1070,33279,51535,33.34820995439992,64.57553119239353,2.076258853206559,66.65179004560008
54,54005,2041,155,6816,9012,22.647581003106968,75.63249001331558,1.7199289835774523,77.35241899689304
54,54007,1457,87,4120,5664,25.723870056497177,72.74011299435028,1.5360169491525424,74.27612994350282
54,54009,2947,164,7545,10656,27.65578078078078,70.80518018018019,1.539039039039039,72.34421921921921
54,54011,14994,645,21721,37360,40.13383297644539,58.13972162740899,1.72644539614561,59.86616702355461
54,54013,568,39,2364,2971,19.118142039717267,79.56916863009089,1.3126893301918545,80.88185796028273
54,54015,641,45,2679,3365,19.049034175334324,79.61367013372957,1.337295690936107,80.95096582466567
54,54017,435,47,2619,3101,14.027732989358272,84.45662689455014,1.5156401160915833,85.97226701064173
54,54019,5063,219,11580,16862,30.026094176254297,68.67512750563397,1.2987783181117305,69.9739058237457
54,54021,599,51,2012,2662,22.501878287002253,75.58226897069872,1.915852742299023,77.49812171299774
54,54023,607,31,4871,5509,11.018333635868578,88.41895080776911,0.5627155563623162,88.98166636413143
54,54025,4655,270,10925,15850,29.369085173501574,68.92744479495269,1.7034700315457414,70.63091482649843
54,54027,1939,114,8033,10086,19.224667856434664,79.64505254808645,1.1302795954788816,80.77533214356534
54,54029,3790,204,9806,13800,27.463768115942027,71.05797101449275,1.4782608695652173,72.53623188405797
54,54031,1381,91,4859,6331,21.813299636708262,76.74932870004739,1.4373716632443532,78.18670036329173
54,54033,9215,567,20683,30465,30.24782537337929,67.89102248481865,1.861152141802068,69.75217462662071
54,54035,3207,208,10093,13508,23.741486526502815,74.71868522357121,1.53982824992597,76.25851347349719
54,54037,12127,543,15033,27703,43.77504241417897,54.26488105981302,1.9600765260080137,56.22495758582103
54,54039,34344,1502,46398,82244,41.75866932542191,56.41505763338359,1.8262730411944945,58.24133067457809
54,54041,1538,137,5782,7457,20.624916186133834,77.53788386750703,1.8371999463591255,79.37508381386617
54,54043,1711,107,6012,7830,21.85185185185185,76.7816091954023,1.3665389527458494,78.14814814814815
54,54045,2333,159,10534,13026,17.910333179794257,80.86903116843237,1.2206356517733763,82.08966682020574
54,54047,1333,46,5148,6527,20.422858893825648,78.8723762831316,0.7047648230427455,79.57714110617435
54,54049,8901,593,16300,25794,34.508025122121424,63.19299061797318,2.2989842599054042,65.49197487787858
54,54051,3455,190,10435,14080,24.538352272727273,74.1122159090909,1.3494318181818181,75.46164772727272
54,54053,2511,216,8422,11149,22.522199300385683,75.5404072114091,1.9373934882052202,77.47780069961432
54,54055,5556,341,19237,25134,22.10551444258773,76.5377576191613,1.3567279382509747,77.89448555741227
54,54057,2660,172,10040,12872,20.665009322560596,77.99875699192044,1.3362336855189558,79.33499067743941
54,54059,1385,81,8521,9987,13.868028436968057,85.32091719235005,0.8110543706818865,86.13197156303194
54,54061,20282,987,20803,42072,48.20783418900932,49.44618748811561,2.3459783228750712,51.79216581099068
54,54063,1345,77,5068,6490,20.724191063174114,78.08936825885978,1.1864406779661016,79.27580893682588
54,54065,1998,160,6537,8695,22.97872340425532,75.18113858539391,1.8401380103507763,77.02127659574468
54,54067,2226,125,8279,10630,20.940733772342426,77.88334901222954,1.175917215428034,79.05926622765757
54,54069,7223,321,12354,19898,36.30013066639863,62.086641873555124,1.613227460046236,63.69986933360137
54,54071,820,57,2782,3659,22.41049467067505,76.03170265099754,1.557802678327412,77.58950532932495
54,54073,699,50,2742,3491,20.022916069894016,78.54482956173017,1.4322543683758235,79.97708393010598
54,54075,1047,66,2895,4008,26.122754491017965,72.23053892215569,1.6467065868263475,73.87724550898204
54,54077,3163,219,11190,14572,21.70601152895965,76.7911062311282,1.5028822399121602,78.29398847104035
54,54079,7878,589,20034,28501,27.64113539875794,70.29227044665099,2.0665941545910673,72.35886460124206
54,54081,7982,451,24673,33106,24.11043315411104,74.52727602247326,1.362290823415695,75.88956684588896
54,54083,3362,165,8673,12200,27.557377049180324,71.09016393442623,1.3524590163934427,72.44262295081967
54,54085,586,48,3649,4283,13.681998599112772,85.19729161802475,1.1207097828624797,86.31800140088723
54,54087,1455,95,4213,5763,25.247267048412287,73.10428596217248,1.6484469894152352,74.75273295158772
54,54089,1448,63,4074,5585,25.926589077887197,72.94538943598926,1.1280214861235454,74.0734109221128
54,54091,1796,110,5477,7383,24.32615467966951,74.1839360693485,1.4899092509819856,75.67384532033049
54,54093,938,65,2841,3844,24.40166493236212,73.90738813735692,1.6909469302809572,75.59833506763788
54,54095,631,65,3226,3922,16.088730239673634,82.25395206527281,1.657317695053544,83.91126976032636
54,54097,2256,194,7771,10221,22.07220428529498,76.02974268662558,1.8980530280794443,77.92779571470501
54,54099,4088,274,12585,16947,24.12226352746799,74.26093113825456,1.6168053342774533,75.877736472532
54,54101,610,33,2759,3402,17.930629041740154,81.09935332157553,0.9700176366843033,82.06937095825984
54,54103,1539,135,4993,6667,23.083845807709615,74.89125543722814,2.024898755062247,76.91615419229038
54,54105,466,53,2134,2653,17.565020731247643,80.43724085940444,1.997738409347908,82.43497926875236
54,54107,10816,624,26963,38403,28.16446631773559,70.21066062547196,1.624873056792438,71.83553368226441
54,54109,1157,82,7353,8592,13.466014897579143,85.5796089385475,0.9543761638733707,86.53398510242086
55,55001,4329,127,7362,11818,36.630563547131494,62.294804535454396,1.0746319174141141,63.369436452868506
55,55003,4801,115,3841,8757,54.82471165924403,43.8620532145712,1.3132351261847666,45.17528834075597
55,55005,9194,349,15803,25346,36.27396827901839,62.349088613587945,1.3769431073936715,63.72603172098161
55,55007,6147,116,4617,10880,56.49816176470588,42.435661764705884,1.0661764705882353,43.50183823529412
55,55009,65511,2635,75871,144017,45.48837984404619,52.681975044612784,1.8296451113410224,54.51162015595381
55,55011,2860,122,4834,7816,36.59160696008188,61.8474923234391,1.5609007164790174,63.40839303991812
55,55013,3569,110,6462,10141,35.193767872990826,63.721526476678825,1.0847056503303423,64.80623212700917
55,55015,12116,502,18156,30774,39.37089751088581,58.99785533242348,1.6312471566907132,60.62910248911419
55,55017,13983,638,21317,35938,38.90867605320274,59.3160442985141,1.7752796482831543,61.09132394679726
55,55019,4524,372,10002,14898,30.36649214659686,67.1365283930729,2.4969794603302455,69.63350785340315
55,55021,16410,532,16927,33869,48.45138622339012,49.97785585638785,1.5707579202220319,51.54861377660988
55,55023,3953,122,4620,8695,45.462909718228865,53.133985048878664,1.403105232892467,54.537090281771135
55,55025,260185,5806,78800,344791,75.46165648175271,22.85442485447706,1.6839186637702261,24.538343518247288
55,55027,16356,725,31355,48436,33.76827153357007,64.73490791972912,1.4968205467008011,66.23172846642993
55,55029,10044,321,9752,20117,49.92792165829895,48.47641298404335,1.5956653576577025,50.07207834170105
55,55031,13218,536,10923,24677,53.56404749361754,44.26388945171617,2.1720630546662885,46.43595250638246
55,55033,9897,454,13173,23524,42.071926543104915,55.99812956980106,1.9299438870940315,57.928073456895085
55,55035,31620,1314,25341,58275,54.259974259974264,43.48519948519948,2.2548262548262548,45.740025740025736
55,55037,781,26,2133,2940,26.564625850340136,72.55102040816327,0.8843537414965987,73.43537414965986
55,55039,20588,909,35754,57251,35.960943913643426,62.45131089413285,1.5877451922237167,64.03905608635657
55,55041,1721,47,3285,5053,34.058974866415994,65.01088462299623,0.9301405105877696,65.941025133584
55,55043,10998,468,14142,25608,42.947516401124645,55.22492970946578,1.8275538894095593,57.052483598875355
55,55045,10851,386,10169,21406,50.691394935999256,47.50537232551621,1.8032327384845372,49.308605064000744
55,55047,3344,159,7168,10671,31.337269234373537,67.17271108612127,1.490019679505201,68.66273076562646
55,55049,7828,255,5909,13992,55.94625500285878,42.231275014293885,1.8224699828473412,44.05374499714122
55,55051,1533,39,2438,4010,38.229426433915215,60.79800498753117,0.972568578553616,61.770573566084785
55,55053,4256,137,5791,10184,41.7910447761194,56.863707776904945,1.3452474469756481,58.2089552238806
55,55055,19904,867,27208,47979,41.48481627378644,56.70814314595969,1.807040580253861,58.51518372621356
55,55057,4746,214,8749,13709,34.61959296812313,63.81938872273689,1.5610183091399812,65.38040703187687
55,55059,42193,1573,44972,88738,47.5478374540783,50.67952849962813,1.7726340462935832,52.4521625459217
55,55061,3976,192,7927,12095,32.873088052914426,65.53947912360479,1.587432823480777,67.12691194708557
55,55063,37846,1354,28684,67884,55.75098697778563,42.254434034529496,1.994578987684874,44.24901302221437
55,55065,3647,87,4821,8555,42.63004091174752,56.353009935710105,1.0169491525423728,57.36995908825248
55,55067,3704,131,7330,11165,33.17510076130766,65.65158978952083,1.1733094491715181,66.82489923869234
55,55069,6261,219,10017,16497,37.95235497363157,60.720130932896886,1.3275140934715404,62.04764502636843
55,55071,16818,793,27218,44829,37.51589372950546,60.715162060273485,1.7689442102210622,62.48410627049454
55,55073,30808,1319,44624,76751,40.14019361311254,58.141262003100934,1.7185443837865304,59.85980638688746
55,55075,7366,309,15304,22979,32.0553548892467,66.59993907480744,1.3447060359458636,67.9446451107533
55,55077,3239,107,5719,9065,35.73083287369002,63.08880308880309,1.1803640375068947,64.26916712630998
55,55078,1303,9,278,1590,81.9496855345912,17.48427672955975,0.5660377358490566,18.050314465408803
55,55079,317270,7344,134357,458971,69.12637181869879,29.273527085589286,1.6001010957119297,30.873628181301214
55,55081,8433,403,13775,22611,37.296006368581665,60.92167529078767,1.7823183406306664,62.703993631418335
55,55083,6715,274,16226,23215,28.925263838035754,69.8944647856989,1.1802713762653456,71.07473616196424
55,55085,10105,383,13671,24159,41.8270623784097,56.587607102943004,1.585330518647295,58.1729376215903
55,55087,47667,1970,58385,108022,44.127122252874415,54.04917516802132,1.8237025791042565,55.872877747125585
55,55089,26517,1057,33912,61486,43.12689067429984,55.154018801027874,1.7190905246722832,56.87310932570016
55,55091,1489,71,2584,4144,35.931467181467184,62.35521235521235,1.7133204633204633,64.06853281853282
55,55093,9839,716,12903,23458,41.943047148094465,55.004689231818574,3.052263620086964,58.056952851905535
55,55095,9370,390,16611,26371,35.531455007394484,62.98964771908536,1.4788972735201547,64.46854499260552
55,55097,20428,876,19299,40603,50.31155333349753,47.530970617934635,2.15747604856784,49.68844666650247
55,55099,3032,120,5394,8546,35.47858647320384,63.11724783524456,1.404165691551603,64.52141352679615
55,55101,50159,1813,54479,106451,47.11933189918366,51.17753708278926,1.7031310180270733,52.88066810081634
55,55103,3995,148,4871,9014,44.31994674950078,54.0381628577768,1.6418903927224318,55.68005325049922
55,55105,46658,1564,37138,85360,54.660262417994375,43.50749765698219,1.8322399250234302,45.339737582005625
55,55107,2517,112,5257,7886,31.917321836165357,66.66243976667512,1.4202383971595232,68.08267816383464
55,55109,23190,1318,32199,56707,40.89442220537147,56.78134974518137,2.324228049447158,59.10557779462853
55,55111,18108,602,17493,36203,50.01795431317847,48.31920006629285,1.6628456205286852,49.98204568682153
55,55113,4498,103,5909,10510,42.797335870599426,56.22264509990485,0.9800190294957184,57.202664129400574
55,55115,7131,303,15173,22607,31.54332728800814,67.11637988233733,1.3402928296545318,68.45667271199186
55,55117,27101,1293,37609,66003,41.06025483690136,56.98074329954699,1.9590018635516566,58.93974516309864
55,55119,2693,336,7655,10684,25.20591538749532,71.6491950580307,3.14488955447398,74.79408461250468
55,55121,6285,102,8833,15220,41.29434954007885,58.03547963206307,0.6701708278580815,58.70565045992115
55,55123,7457,239,8218,15914,46.85811235390223,51.64006535126304,1.5018222948347366,53.14188764609777
55,55125,5903,205,9261,15369,38.40848461188106,60.25766152644935,1.3338538616695947,61.59151538811894
55,55127,22789,960,33851,57600,39.564236111111114,58.76909722222222,1.6666666666666667,60.435763888888886
55,55129,3867,177,6334,10378,37.26151474272499,61.03295432645982,1.705530930815186,62.73848525727501
55,55131,26650,1183,60237,88070,30.260020438287725,68.39672987396389,1.343249687748382,69.73997956171227
55,55133,103906,4441,159649,267996,38.77147420110748,59.57141151360468,1.65711428528784,61.22852579889252
55,55135,9703,475,18952,29130,33.30930312392722,65.06007552351528,1.6306213525575006,66.69069687607278
55,55137,4388,164,9016,13568,32.340801886792455,66.4504716981132,1.2087264150943398,67.65919811320754
55,55139,44060,2304,47796,94160,46.792693288020395,50.76040781648258,2.4468988954970263,53.207306711979605
55,55141,16365,625,24308,41298,39.626616301031525,58.85999322001065,1.5133904789578188,60.373383698968475
56,56001,9092,946,8579,18617,48.8370843852393,46.081538378901,5.081377235859698,51.1629156147607
56,56003,788,158,4806,5752,13.699582753824757,83.55354659248957,2.7468706536856744,86.30041724617524
56,56005,1935,656,16975,19566,9.889604415823367,86.7576408054789,3.352754778697741,90.11039558417663
56,56007,1427,223,5014,6664,21.413565426170468,75.24009603841537,3.3463385354141657,78.58643457382954
56,56009,861,192,5917,6970,12.352941176470589,84.89239598278336,2.7546628407460543,87.6470588235294
56,56011,378,90,3651,4119,9.176984705025491,88.6380189366351,2.1849963583394025,90.82301529497451
56,56013,5519,585,12007,18111,30.47319308707415,66.29672574678372,3.2300811661421234,69.52680691292585
56,56015,1203,160,4878,6241,19.275757090209904,78.16055119371896,2.5636917160711423,80.72424290979009
56,56017,482,96,1999,2577,18.703919285991464,77.5708187815289,3.7252619324796274,81.29608071400854
56,56019,897,136,3881,4914,18.253968253968253,78.97842897842898,2.7676027676027677,81.74603174603175
56,56021,15217,1874,27891,44982,33.82908719043173,62.0048019207683,4.166110888799964,66.17091280956828
56,56023,1509,316,8643,10468,14.415361100496751,82.56591517004203,3.0187237294612155,85.58463889950325
56,56025,8530,1401,25271,35202,24.231577751264133,71.78853474234418,3.979887506391682,75.76842224873587
56,56027,155,35,1118,1308,11.850152905198778,85.47400611620795,2.675840978593272,88.14984709480122
56,56029,3410,494,12813,16717,20.398396841538556,76.64652748698929,2.9550756714721538,79.60160315846144
56,56031,890,135,3898,4923,18.078407475116798,79.17936217753403,2.742230347349177,81.92159252488321
56,56033,4043,542,11843,16428,24.610421232042853,72.09033357682006,3.299245191137083,75.38957876795715
56,56035,882,131,3957,4970,17.74647887323944,79.61770623742454,2.6358148893360163,82.25352112676056
56,56037,3823,551,12229,16603,23.025959164006505,73.65536348852618,3.3186773474673257,76.97404083599349
56,56039,9848,488,4341,14677,67.09818082714452,29.576889010015673,3.3249301628398173,32.90181917285548
56,56041,1591,315,7496,9402,16.921931503935333,79.72771750691342,3.350350989151244,83.07806849606467
56,56043,651,116,3245,4012,16.22632103688933,80.88235294117648,2.8913260219341974,83.77367896311067
56,56045,360,75,3107,3542,10.163749294184077,87.71880293619424,2.1174477696216827,89.83625070581593
